-ahtaa	-ɑhtɑːˣ
-ksia	-ksiɑˣ
.fi	ˈpisteˣˌfi(ː)
200 metrin juoksu	ˈkɑhden ˈsɑdɑn ˈmetrin ˈjuo̯ksu
4H-toiminta	ˈneljæˌhoːˌtoi̯mintɑ
A-pilari	ˈɑːˌpilɑri
Aaron	ˈɑːron
Aava	ˈɑːʋɑ
Ahvenanmaa	ˈɑhʋenɑnˌmɑː
Aila	ˈɑi̯lɑ
Aina	ˈɑi̯nɑ
Aini	ˈɑi̯ni
Aiskhylos	ˈɑi̯skhylos
Akaa	ˈɑkɑː
Aki	ˈɑki
Aku Ankka	ˈɑku ˈɑŋkːɑ
Alabama	ˈɑlɑbɑmɑ
Albertiina	ˈɑlbertiːnɑ
Aleksanteri	ˈɑleksɑnteri
Alex	ˈɑleks
Alpo	ˈɑlpo
Annala	ˈɑnːɑlɑ
Anni	ˈɑnːi
Antton	ˈɑntːon
Asklepios	ˈɑskle(ː)pios
Aulikki	ˈɑu̯likːi
Aura	ˈɑu̯rɑ
Brasilia	ˈbrɑsiliɑ
D-pilari	ˈdeːˌpilɑri
Delfiini	ˈdelfiːni
Eeli	ˈeːli
Eerika	ˈeːrikɑ
Eevert	ˈeːʋert
Elias	ˈeliɑs
Elo	ˈelo
Eridanus	ˈeridɑnus
Es-duuri	ˈesˌduːri
Etelänapamanner	ˈetelæˌnɑpɑˌmɑnːer
Eurooppa	ˈeu̯roːpːɑ
Euroviisut	ˈeu̯roˌʋiːsut
Fis-duuri	ˈfisˌduːri
Formula 1	ˈformulɑ ˈykːønen
Gaia	ˈɡɑi̯ɑ
H-teräs	ˈhoːˌteræs
HIFK	ˈhifk(i)
Hankasalmi	ˈhɑŋkɑˌsɑlmi
Hanna	ˈhɑnːɑ
Harjavalta	ˈhɑrjɑʋɑltɑ
Harppi	ˈhɑrpːi
Heikkinen	ˈhei̯kːinen
Heinola	ˈhei̯nolɑ
Helsingör	ˈhelsiŋːø(ː)r
Henrikki	ˈhenrikːi
Herkko	ˈherkːo
Heta	ˈhetɑ
Hilla	ˈhilːɑ
Hilppa	ˈhilpːɑ
Hulkko	ˈhulkːo
Humppila	ˈhumpːilɑ
Hyrynsalmi	ˈhyrynˌsɑlmi
Hyvinkää	ˈhyʋiŋkæː
Iina	ˈiːnɑ
Iisa	ˈiːsɑ
Indonesia	ˈindone(ː)s(ː)iɑ
Intia	ˈintiɑ
Iowa	ˈioʋɑ
Irlanti	ˈirlɑnti
Isko	ˈisko
Islanti	ˈislɑnti
Isokangas	ˈisoˌkɑŋːɑs
Jaakola	ˈjɑːkolɑ
Jaava	ˈjɑːʋɑ
Janakkala	ˈjɑnɑkːɑlɑ
Jonna	ˈjonːɑ
Julia	ˈju(ː)liɑ
Jumala	ˈjumɑlɑ
Jumalan terve	ˈjumɑlɑn ˈterʋeˣ
Jupiter	ˈjupiter
Justiina	ˈjustiːnɑ
Kalevanpoika	ˈkɑleʋɑnˌpoi̯kɑ
Kanta-Häme	ˈkɑntɑˌhæmeˣ
Karatšai-Tšerkessia	ˈkɑrɑtʃɑi̯ˌtʃerkesːiɑ
Karjala	ˈkɑrjɑlɑ
Karstula	ˈkɑrstulɑ
Karvia	ˈkɑrʋiɑ
Kassiopeia	ˈkɑsːiopei̯ɑ
Kauko	ˈkɑu̯ko
Kauppinen	ˈkɑu̯pːinen
Kaustinen	ˈkɑu̯stinen
Keijo	ˈkei̯jo
Kettunen	ˈketːunen
Kiehimänjoki	ˈkie̯himænˌjoki
Kirkkonummi	ˈkirkːoˌnumːi
Konstantinus	ˈkonstɑntinus
Korinttolaiskirje	ˈkorintːolɑi̯sˌkirjeˣ
Koski	ˈkoski
Koskinen	ˈkoskinen
Koutokeino	ˈkou̯tokei̯no
Kristiinankaupunki	ˈkristiːnɑnˌkɑu̯puŋki
Kruunupyy	ˈkruːnuˌpyː
Kukka	ˈkukːɑ
Kukko	ˈkukːo
Kustavi	ˈkustɑʋi
Kuusamo	ˈkuːsɑmo
Kyyjärvi	ˈkyːˌjærʋi
Kyösti	ˈkyø̯sti
Kärppä	ˈkærpːæ
Kärsämäki	ˈkærsæˌmæki
Käärmeenkantaja	ˈkæːrmeːnˌkɑntɑjɑ
LA-puhelin	ˈælˌɑːˌpuhelin
Laakkonen	ˈlɑːkːonen
Laila	ˈlɑi̯lɑ
Laimi	ˈlɑi̯mi
Lassila	ˈlɑsːilɑ
Laura	ˈlɑu̯rɑ
Lehtinen	ˈlehtinen
Lehtola	ˈlehtolɑ
Lempaala	ˈlempɑːlɑ
Lentokala	ˈlentoˌkɑlɑ
Leppävirta	ˈlepːæˌʋirtɑ
Lumivalko	ˈlumiʋɑlko
Lyyli	ˈlyːli
Lyytikäinen	ˈlyːtikæi̯nen
Länsi-Virginia	ˈlænsiˌʋirɡi(ː)niɑ
Maarit	ˈmɑːrit
Makedonia	ˈmɑkedoniɑ
Makkonen	ˈmɑkːonen
Malta	ˈmɑltɑ
Mara	ˈmɑrɑ
Maria	ˈmɑriɑ
Martti	ˈmɑrtːi
Matleena	ˈmɑtleːnɑ
Mauri	ˈmɑu̯ri
Mervi	ˈmerʋi
Mielikki	ˈmie̯likːi
Miko	ˈmiko
Mila	ˈmilɑ
Minna	ˈminːɑ
Mirja	ˈmirjɑ
Mooses	ˈmoːses
Multia	ˈmultiɑ
Muurmanni	ˈmuːrmɑnːi
Mynämäki	ˈmynæˌmæki
Myrskylä	ˈmyrskylæ
Mäkilä	ˈmækilæ
NMKY	ˈænːˌæmːˌkoːˌyː
Napoli	ˈnɑpoli
Natanael	ˈnɑtɑnɑel
Neptunus	ˈneptunus
Neuvostoliitto	ˈneu̯ʋostoˌliːtːo
Niemi	ˈnie̯mi
Niina	ˈniːnɑ
Nikkilä	ˈnikːilæ
Nina	ˈni(ː)nɑ
Noora	ˈnoːrɑ
Norlanti	ˈnorlɑnti
Nousiainen	ˈnou̯siɑi̯nen
Nurmijärvi	ˈnurmiˌjærʋi
OYJ	ˈoːˌyːˌjiː
Oinas	ˈoi̯nɑs
Ojala	ˈojɑlɑ
Onni	ˈonːi
Oskari	ˈoskɑri
Ossi	ˈosːi
Oulu	ˈou̯lu
Paltamo	ˈpɑltɑmo
Peltola	ˈpeltolɑ
Pennsylvania	ˈpensilʋei̯niɑ
Pertunmaa	ˈpertunˌmɑː
Petra	ˈpetrɑ
Pieni koira	ˈpie̯ni ˈkoi̯rɑ
Pihla	ˈpihlɑ
Pirita	ˈpiritɑ
Pjongjang	ˈpjoŋjɑŋː
Polvijärvi	ˈpolʋiˌjærʋi
Pomarkku	ˈpomɑrkːu
Puolimatka	ˈpuo̯liˌmɑtkɑ
Pyhäjoki	ˈpyhæˌjoki
Pähkinälinna	ˈpæhkinæˌlinːɑ
Päivikki	ˈpæi̯ʋikːi
Päiviö	ˈpæi̯ʋiø
Ranua	ˈrɑnuɑ
Riitta	ˈriːtːɑ
Riku	ˈriku
Rissanen	ˈrisːɑnen
Ritva	ˈritʋɑ
Rossi	ˈrosːi
Ruija	ˈrui̯jɑ
aakkosnimi	ˈɑːkːosˌnimi
aallottaa	ˈɑːlːotːɑːˣ
aaltoilu	ˈɑːltoi̯lu
aamen	ˈɑːmen
aamuisin	ˈɑːmui̯sin
aamuneljä	ˈɑːmuˌneljæ
aamutyö	ˈɑːmuˌtyø̯
aapa	ˈɑːpɑ
aaria	ˈɑːriɑ
aasi	ˈɑːsi
aateli	ˈɑːteli
aatelointi	ˈɑːteloi̯nti
aavistaa	ˈɑːʋistɑːˣ
abdominaalinen	ˈɑbdominɑːlinen
ableismi	ˈɑblei̯smi
abrakadabra	ˈɑbrɑkɑdɑbrɑ
absorboituminen	ˈɑbsorboi̯tuminen
abstrakti	ˈɑbs.trɑkti
abuulinen	ˈɑbuːlinen
addiktoiva	ˈɑdːiktoi̯ʋɑ
adipolyysi	ˈɑdipolyːsi
adrenaliini	ˈɑdrenɑliːni
adverbi	ˈɑdʋerbi
aerodynamiikka	ˈɑeroˌdynɑmiːkːɑ
afgaani	ˈɑfɡɑːni
afrikkalainen	ˈɑfrikːɑlɑi̯nen
agalmatoliitti	ˈɑɡɑlmɑtoliːtːi
agility	ˈɑɡility
agogiikka	ˈɑɡoɡiːkːɑ
ahaa	ˈɑhɑː
ahdin	ˈɑhdin
ahdos	ˈɑhdos
ahma	ˈɑhmɑ
ahnehtia	ˈɑhnehtiɑˣ
ahtautuminen	ˈɑhtɑu̯tuminen
aiai	ˈɑi̯ɑi̯
aigeialainen	ˈɑi̯ɡei̯ɑlɑi̯nen
aiheuttaminen	ˈɑi̯heutːɑminen
aikaan	ˈɑi̯kɑːn
aikainen lintu madon nappaa	ˈɑi̯kɑi̯nen ˈlintu ˈmɑdon ˈnɑpːɑː
aikakatkaista	ˈɑi̯kɑˌkɑtkɑi̯stɑˣ
aikamatka	ˈɑi̯kɑˌmɑtkɑ
aikapommi	ˈɑi̯kɑˌpomːi
aikataulutus	ˈɑi̯kɑˌtɑu̯lutus
aikomus	ˈɑi̯komus
aineisto	ˈɑi̯nei̯sto
aioli	ˈɑi̯oli
airi	ˈɑi̯ri
aistinsisältö	ˈɑi̯stinˌsisæltø
aitomaksasammal	ˈɑi̯toˌmɑksɑˌsɑmːɑl
aivasteleminen	ˈɑi̯ʋɑsteleminen
aivokäyrä	ˈɑi̯ʋoˌkæy̯ræ
aivotieteilijä	ˈɑi̯ʋoˌtie̯tei̯lijæ
ajaa	ˈɑjɑːˣ
ajanhallinta	ˈɑjɑnˌhɑlːintɑ
ajanvaraus	ˈɑjɑnˌʋɑrɑus
ajaton	ˈɑjɑton
ajatusten Tonava	ˈɑjɑtusten ˈtonɑʋɑ
ajeluttaminen	ˈɑjelutːɑminen
ajoittaminen	ˈɑjoi̯tːɑminen
ajokone	ˈɑjoˌkoneˣ
ajoneuvotekniikka	ˈɑjoˌneu̯ʋoˌtekniːkːɑ
akku	ˈɑkːu
akkuvirta	ˈɑkːuˌʋirtɑ
akryylikuitu	ˈɑkryːliˌkui̯tu
aksentoida	ˈɑksentoi̯dɑˣ
aksoni	ˈɑksoni
aktiivistuminen	ˈɑktiːʋistuminen
aktivoituminen	ˈɑktiʋoi̯tuminen
akvaario	ˈɑkʋɑːrio
alailmakehä	ˈɑlɑˌilmɑˌkehæ
alajärveläinen	ˈɑlɑˌjærʋelæi̯nen
alakierrelyönti	ˈɑlɑˌkie̯rːeˣˌlyø̯nti
alakulminaatio	ˈɑlɑˌkulminɑːtio
alakynnessä	ˈɑlɑˌkynːesːæ
alalleen	ˈɑlɑlːeːn
alamäki	ˈɑlɑˌmæki
alanvalinta	ˈɑlɑnˌʋɑlintɑ
alapesu	ˈɑlɑˌpesu
alapuolelta	ˈɑlɑˌpuo̯leltɑ
alas	ˈɑlɑs
alaspäinmeno	ˈɑlɑsˌpæi̯nˌmeno
alasumma	ˈɑlɑˌsumːɑ
alatasokone	ˈɑlɑˌtɑsoˌkoneˣ
alatuulessa	ˈɑlɑˌtuːlesːɑ
alaviistossa	ˈɑlɑˌʋiːstosːɑ
alayhteisö	ˈɑlɑˌyhtei̯sø
alempana	ˈɑlempɑnɑ
alhaalle	ˈɑlhɑːlːeˣ
aliarviointi	ˈɑliˌɑrʋioi̯nti
alihinta	ˈɑliˌhintɑ
alikanta	ˈɑliˌkɑntɑ
alilauseke	ˈɑliˌlɑu̯sekeˣ
alimonoidi	ˈɑliˌmonoi̯di
alipaine	ˈɑliˌpɑi̯neˣ
alipääsihteeri	ˈɑliˌpæːˌsihteːri
alistua	ˈɑlistuɑˣ
alisuoriutuminen	ˈɑliˌsuo̯riu̯tuminen
alitse	ˈɑlitseˣ
aliupseerinarvo	ˈɑliˌupseːrinˌɑrʋo
alivalotus	ˈɑliˌʋɑlotus
aljo	ˈɑljo
alkalointi	ˈɑlkɑloi̯nti
alkeismatriisi	ˈɑlkei̯sˌmɑtriːsi
alkeisvarsikko	ˈɑlkei̯sˌʋɑrsikːo
alkoholi	ˈɑlkoholi
alkoholiprosentti	ˈɑlkoholiˌprosentːi
alkomahooli	ˈɑlkomɑhoːli
alkujaan	ˈɑlkujɑːn
alkukoulutus	ˈɑlkuˌkou̯lutus
alkulähde	ˈɑlkuˌlæhdeˣ
alkuopinnot	ˈɑlkuˌopinːot
alkuperäistila	ˈɑlkuˌperæi̯sˌtilɑ
alkuräjähdys	ˈɑlkuˌræjæhdys
alkusyy	ˈɑlkuˌsyː
alkutunnari	ˈɑlkuˌtunːɑri
alkuvauhti	ˈɑlkuˌʋɑu̯hti
allaniitti	ˈɑlːɑniːtːi
allekirjoittanut	ˈɑlːeˣˌkirjoi̯tːɑnut
allergisoituminen	ˈɑlːerɡisoi̯tuminen
allit	ˈɑlːit
almikki	ˈɑlmikːi
aloittava	ˈɑloi̯tːɑʋɑ
aloituspiste	ˈɑloi̯tusˌpisteˣ
alppiseutu	ˈɑlpːiˌseu̯tu
altis	ˈɑltis
altocumulus	ˈɑltoˌkumulus
alttaritaulu	ˈɑltːɑriˌtɑu̯lu
alu-	ˈɑlu-
aluekehittämistoiminta	ˈɑlueˣˌkehitːæmisˌtoi̯mintɑ
alueohjelma	ˈɑlueˣˌohjelmɑ
aluevaatimus	ˈɑlueˣˌʋɑːtimus
alula	ˈɑlulɑ
alun perin	ˈɑlun ˈperin
aluspuku	ˈɑlusˌpuku
alusvaatteisilleen	ˈɑlusˌʋɑːtːei̯silːeːn
amalgaami	ˈɑmɑlɡɑːmi
amazoninmanaatti	ˈɑmɑtsoninˌmɑnɑːtːi
amenorrea	ˈɑmenorːeɑ
amerikkalainen	ˈɑmerikːɑlɑi̯nen
aminohippurihappo	ˈɑminoˌhipːuriˌhɑpːo
amk-insinööri	ˈɑːˌæmˌkoːˌinsinøːri
ammattikirja	ˈɑmːɑtːiˌkirjɑ
ammattimerkki	ˈɑmːɑtːiˌmerkːi
amme	ˈɑmːeˣ
ammonilainen	ˈɑmːonilɑi̯nen
ammuskelu	ˈɑmːuskelu
ampua	ˈɑmpuɑˣ
ampumapesäke	ˈɑmpumɑˌpesækeˣ
amygdaliini	ˈɑmyɡdɑliːni
anakronistinen	ˈɑnɑˌkronistinen
analyyttinen geometria	ˈɑnɑlyːtːinen ˈɡeometriɑ
anarkistinen	ˈɑnɑrkistinen
anatominen	ˈɑnɑtominen
andrologia	ˈɑndroloɡiɑ
anergia	ˈɑnerɡiɑ
angiogeneesi	ˈɑŋːioˌɡeneːsi
angsti	ˈɑŋsti
anioni	ˈɑnioni
anjovis	ˈɑnjoʋis
ankkalinnalainen	ˈɑŋkːɑˌlinːɑlɑi̯nen
anniskelupassi	ˈɑnːiskeluˌpɑsːi
annotaatio	ˈɑnːotɑːtio
anopikset	ˈɑnopikset
ansas	ˈɑnsɑs
ansiotarkoitus	ˈɑnsioˌtɑrkoi̯tus
antediluviaani	ˈɑntediluʋiɑːni
antidepressantti	ˈɑntiˌdepresːɑntːi
antikommutointi	ˈɑntiˌkomːutoi̯nti
antimyoni	ˈɑntiˌmyoni
antonyymi	ˈɑntonyːmi
aoristi	ˈɑoristi
apara	ˈɑpɑrɑ
apeutuminen	ˈɑpeu̯tuminen
apliitti	ˈɑpliːtːi
apolloperhonen	ˈɑpolːoˌperhonen
appela	ˈɑpːelɑ
approksimatiivi	ˈɑpːroksimɑtiːʋi
apriorisesti	ˈɑˌpriorisestiˣ
apulause	ˈɑpuˌlɑu̯seˣ
apuvalmentaja	ˈɑpuˌʋɑlmentɑjɑ
araknologia	ˈɑrɑknoˌloɡiɑ
areafunktio	ˈɑreɑˌfuŋktio
arginaasi	ˈɑrɡinɑːsi
aridi	ˈɑridi
aristotelismi	ˈɑristotelismi
arkaainen	ˈɑrkɑːinen
arkanahkainen	ˈɑrkɑˌnɑhkɑi̯nen
arki	ˈɑrki
arkinsyöttölaite	ˈɑrkinˌsyø̯tːøˌlɑi̯teˣ
arkiruoka	ˈɑrkiˌruo̯kɑ
arkistokelpoinen	ˈɑrkistoˌkelpoi̯nen
arkitunnelma	ˈɑrkiˌtunːelmɑ
arkkipainokone	ˈɑrkːiˌpɑi̯noˌkoneˣ
arkkutuoli	ˈɑrkːuˌtuo̯li
armas	ˈɑrmɑs
armenialainen	ˈɑrmeniɑlɑi̯nen
armoleipä	ˈɑrmoˌlei̯pæ
arokasvi	ˈɑroˌkɑsʋi
arpa	ˈɑrpɑ
arpeggiaattori	ˈɑrpeɡːiɑːtːori
arsenikkimyrkytys	ˈɑrsenikːiˌmyrkytys
artikulaatio	ˈɑrtikulɑːtio
arvata	ˈɑrʋɑtɑˣ
arvelu	ˈɑrʋelu
arvioiminen	ˈɑrʋioi̯minen
arviosumma	ˈɑrʋioˌsumːɑ
arvoasema	ˈɑrʋoˌɑsemɑ
arvojohtaja	ˈɑrʋoˌjohtɑjɑ
arvokilpi	ˈɑrʋoˌkilpi
arvoleima	ˈɑrʋoˌlei̯mɑ
arvonimistö	ˈɑrʋoˌnimistø
arvonnousuvero	ˈɑrʋonˌnou̯suˌʋero
arvopaperisalkku	ˈɑrʋoˌpɑperiˌsɑlkːu
arvosidonnaisuus	ˈɑrʋoˌsidonːɑi̯suːs
arvostelukyvytön	ˈɑrʋosteluˌkyʋytøn
arvoton	ˈɑrʋoton
arvoväritys	ˈɑrʋoˌʋæritys
aseapu	ˈɑseˣˌɑpu
aseistariisuva	ˈɑsei̯stɑˌriːsuʋɑ
asemalaituri	ˈɑsemɑˌlɑi̯turi
asenne	ˈɑsenːeˣ
asetaattifilmi	ˈɑsetɑːtːiˌfilmi
asettautuminen	ˈɑsetːɑu̯tuminen
asetusjousi	ˈɑsetusˌjou̯si
asfaltoida	ˈɑsfɑltoi̯dɑˣ
asiakasohjelma	ˈɑsiɑkɑsˌohjelmɑ
asianajotoimi	ˈɑsiɑnˌɑjoˌtoi̯mi
asiantila	ˈɑsiɑnˌtilɑ
asiantuntijalausunto	ˈɑsiɑnˌtuntijɑˌlɑu̯sunto
asiasuomi	ˈɑsiɑˌsuo̯mi
asikkalainen	ˈɑsikːɑlɑi̯nen
askare	ˈɑskɑreˣ
askartelunohjaaja	ˈɑskɑrtelunˌohjɑːjɑ
askelpalautin	ˈɑskelˌpɑlɑu̯tin
aspi	ˈɑspi
assimiloitua	ˈɑsːimiloi̯tuɑˣ
assyriologia	ˈɑsːyrioloɡiɑ
astemitta	ˈɑsteˣˌmitːɑ
astian maku	ˈɑstiɑn ˈmɑku
astrologia	ˈɑstroloɡiɑ
astuttaa	ˈɑstutːɑːˣ
asuinpaikkakunta	ˈɑsui̯nˌpɑi̯kːɑˌkuntɑ
asukasneuvosto	ˈɑsukɑsˌneu̯ʋosto
asumisedellytys	ˈɑsumisˌedelːytys
asumistukijärjestelmä	ˈɑsumisˌtukiˌjærjestelmæ
asunto-osake	ˈɑsuntoˌ(ʔ)osɑkeˣ
asuntosäilö	ˈɑsuntoˌsæi̯lø
asvaltoida	ˈɑsʋɑltoi̯dɑˣ
ateria	ˈɑteriɑ
atk-ajokortti	ˈɑːˌteːˌkoːˌɑjoˌkortːi
atomiorbitaali	ˈɑtomiˌorbitɑːli
atsoväri	ˈɑtsoˌʋæri
atulat	ˈɑtulɑt
audiometria	ˈɑu̯dioˌmetriɑ
aukaisin	ˈɑu̯kɑi̯sin
aukominen	ˈɑu̯kominen
auringonpistos	ˈɑu̯riŋːonˌpistos
aurinkoautografi	ˈɑu̯riŋkoˌɑu̯toɡrɑfi
aurinkolasit	ˈɑu̯riŋkoˌlɑsit
aurinkovene	ˈɑu̯riŋkoˌʋeneˣ
australialaisnainen	ˈɑu̯strɑliɑlɑi̯sˌnɑi̯nen
autioitua	ˈɑu̯tioi̯tuɑˣ
autografi	ˈɑu̯toɡrɑfi
autojuna	ˈɑu̯toˌjunɑ
automaattikytkin	ˈɑu̯tomɑːtːiˌkytkin
automaattivaihteisto	ˈɑu̯tomɑːtːiˌʋɑi̯htei̯sto
autonrengas	ˈɑu̯tonˌreŋːɑs
autorata	ˈɑu̯toˌrɑtɑ
autotomia	ˈɑu̯totomiɑ
auvo	ˈɑu̯ʋo
avain	ˈɑʋɑi̯n
avainpari	ˈɑʋɑi̯nˌpɑri
avantosukellus	ˈɑʋɑntoˌsukelːus
avaruus	ˈɑʋɑruːs
avaruuskvantittuminen	ˈɑʋɑruːsˌkʋɑntitːuminen
avaruusraketti	ˈɑʋɑruːsˌrɑketːi
avaskulaarinen	ˈɑʋɑskulɑːrinen
avekki	ˈɑʋekːi
avioida	ˈɑʋioi̯dɑˣ
avitus	ˈɑʋitus
avokysymys	ˈɑʋoˌkysymys
avosydäminen	ˈɑʋoˌsydæm(ː)inen
avustajakoira	ˈɑʋustɑjɑˌkoi̯rɑ
b-molli	ˈbeːˌmolːi
baba	ˈbɑbɑ
bahá&#039;í-usko	ˈbɑhɑːiːˌusko
baittari	ˈbɑi̯tːɑri
balalaikka	ˈbɑlɑlɑi̯kːɑ
balkanmakkara	ˈbɑlkɑnˌmɑkːɑrɑ
bambupuupöytä	ˈbɑmbuˌpuːˌpøy̯tæ
banaaniorava	ˈbɑnɑːniˌorɑʋɑ
bantu	ˈbɑntu
barbituurihappo	ˈbɑrbituːriˌhɑpːo
basalttinen	ˈbɑsɑltːinen
basofiili	ˈbɑsofiːli
bavaroise	ˈbɑʋɑruɑːs
beignet	ˈbenjeː
bensapumppu	ˈbensɑˌpumpːu
berardinvalas	ˈberɑrdinˌʋɑlɑs
berninpaimenkoira	ˈberninˌpɑi̯menˌkoi̯rɑ
betonireikätiili	ˈbetoniˌrei̯kæˌtiːli
bibliografia	ˈbiblioɡrɑfiɑ
bilateraalisuus	ˈbilɑterɑːlisuːs
binaaripuu	ˈbinɑːriˌpuː
bioakustiikka	ˈbioɑkustiːkːɑ
biogerontologi	ˈbioˌɡerontoˌloɡi
biolasi	ˈbioˌlɑsi
bioniikka	ˈbioniːkːɑ
biosimilaari	ˈbioˌsimilɑːri
bioturbaatio	ˈbioˌturbɑːtio
bisnes	ˈbisnes
bitumikeitin	ˈbitumiˌkei̯tin
blankoluotto	ˈblɑŋkoˌluo̯tːo
blogata	ˈbloɡɑtɑˣ
blondaus	ˈblondɑus
body	ˈbody
boikotti	ˈboi̯kotːi
bolševikki	ˈbolʃeʋikːi
boorihappo	ˈboːriˌhɑpːo
boronihappo	ˈboroniˌhɑpːo
botti	ˈbotːi
breseerata	ˈbreseːrɑtɑˣ
briiffi	ˈbriːfːi
bromifenolisininen	ˈbromiˌfenoliˌsininen
brutaali	ˈbrutɑːli
brändi	ˈbrændi
budjettikeskustelu	ˈbudjetːiˌkeskustelu
bulgarialainen	ˈbulɡɑ(ː)riɑlɑi̯nen
bungata	ˈbuŋːɑtɑˣ
burrito	ˈburːito
bussoli	ˈbusːoli
byrokraattistua	ˈbyrokrɑːtːistuɑˣ
bärsse	ˈbærsːeˣ
bébé	ˈbebeː
camembert	ˈkɑmembæːr
cee	ˈseː
cerium	ˈseːri.um
chalaza	ˈkɑlɑtsɑ
chikungunya	ˈtʃikuŋɡunjɑ
chow chow	ˈtʃou̯ˌtʃou̯
city-maasturi	ˈsitiˌmɑːsturi
cocktailkastike	ˈkoktei̯lˌkɑstikeˣ
comeback	ˈkæmbæk
couscous	ˈkuskus
cumulonimbus	ˈkumuloˌnimbus
dagerrotypia	ˈdɑɡerːoˌtypiɑ
damastinen	ˈdɑmɑstinen
data-analyysi	ˈdɑtɑˌ(ʔ)ɑnɑlyːsi
deaminaasi	ˈde.ɑminɑːsi
dedis	ˈdedis
degeneraatioaste	ˈdeɡenerɑːtioˌɑsteˣ
deittailu	ˈdei̯tːɑi̯lu
dekonvoluutio	ˈdekonʋoluːtio
dementoituminen	ˈdementoi̯tuminen
demokraattistaa	ˈdemokrɑːtːistɑːˣ
demonisoida	ˈdemonisoi̯dɑˣ
dendriitti	ˈdendriːtːi
densitometria	ˈdensitometriɑ
depressiolääke	ˈdepresːioˌlæːkeˣ
deses	ˈdeses
desimaalimuoto	ˈdesimɑːliˌmuo̯to
detaljoitu	ˈdetɑljoi̯tu
diabaattinen	ˈdiɑbɑːtːinen
diagnostinen	ˈdiɑɡnostinen
diakonissa	ˈdiɑkonisːɑ
dianetiikka	ˈdiɑnetiːkːɑ
dieeni	ˈdie̯ːni
dieselvero	ˈdiːs(ː)elˌʋero
diffraktometri	ˈdifːrɑktoˌmetri
digi-tv	ˈdiɡiˌteːʋeː
digitalisoiminen	ˈdiɡitɑlisoi̯minen
dijoninsinappi	ˈdijoninˌsinɑpːi
dimetyylihydratsiini	ˈdimetyːliˌhydrɑtsiːni
dipata	ˈdipɑtɑˣ
dippi	ˈdipːi
disharmonia	ˈdis.hɑrmoniɑ
diskordanssi	ˈdiskordɑnsːi
dispergoitua	ˈdisperɡoi̯tuɑˣ
dissosiatiivinen	ˈdisːosiɑtiːʋinen
disulfiraami	ˈdisulfirɑːmi
divertikkeli	ˈdiʋertikːeli
dogmatiikka	ˈdoɡmɑtiːkːɑ
dokumenttikamera	ˈdokumentːiˌkɑmerɑ
dominantti	ˈdominɑntːi
doomscrollaus	ˈduːmˌskrolːɑus
draiveri	ˈdrɑi̯ʋeri
dromedaari	ˈdromedɑːri
dubbaus	ˈdubːɑus
duplikoida	ˈduplikoi̯dɑˣ
dynamiikka	ˈdynɑmiːkːɑ
dysleksia	ˈdysleksiɑ
dödata	ˈdødɑtɑˣ
e-lasku	ˈeːˌlɑsku
edamjuusto	ˈedɑmˌjuːsto
edelliskertainen	ˈedelːisˌkertɑi̯nen
edelläoleva	ˈedelːæˌoleʋɑ
edempää	ˈedempæː
edesvastuu	ˈedesˌʋɑstuː
edistymispalkki	ˈedistymisˌpɑlkːi
edukkuus	ˈedukːuːs
eduskuntakatsaus	ˈedusˌkuntɑˌkɑtsɑus
edusta	ˈedustɑ
edustajantoimi	ˈedustɑjɑnˌtoi̯mi
edustuselin	ˈedustusˌelin
edustustehtävä	ˈedustusˌtehtæʋæ
eesti	ˈeːsti
egyptologi	ˈeɡyptoˌloɡi
ehdonvalta	ˈehdonˌʋɑltɑ
eheyttäminen	ˈeheytːæminen
ehkäistä	ˈehkæi̯stæˣ
ehkäisyvaahto	ˈehkæi̯syˌʋɑːhto
ehtolaiskuulustelu	ˈehtolɑi̯sˌkuːlustelu
ehtoollispöytä	ˈehtoːlːisˌpøy̯tæ
ei mitään	ˈei̯ ˈmitæːn
eine	ˈei̯neˣ
einsteinilainen	ˈɑi̯nstɑi̯nilɑi̯nen
eka	ˈekɑ
ekobetonointi	ˈekoˌbetonoi̯nti
ekolääni	ˈekoˌlæːni
ekosfääri	ˈekoˌsfæːri
ekovelkapäivä	ˈekoˌʋelkɑˌpæi̯ʋæ
eksergia	ˈekserɡiɑ
eksitoni	ˈeksitoni
eksoottinen	ˈeksoːtːinen
eksploitaatio	ˈeksploi̯tɑːtio
eksponoida	ˈeksponoi̯dɑˣ
ekstensometri	ˈekstensoˌmetri
ekstremistinen	ˈekstremistinen
eksyttäminen	ˈeksytːæminen
ekvatoriaali	ˈekʋɑtoriɑːli
elatusvara	ˈelɑtusˌʋɑrɑ
eleganttius	ˈeleɡɑntːius
elektroenkefalogrammi	ˈelektroˌeŋkefɑloˌɡrɑmːi
elektromigraatio	ˈelektroˌmiɡrɑːtio
elektroniikkainsinööri	ˈelektroniːkːɑˌinsinøːri
elektronisesti	ˈelektronisestiˣ
elementti	ˈelementːi
elikkä	ˈelikːæ
elimistö	ˈelimistø
elinajanodote	ˈelinˌɑjɑnˌodoteˣ
elinkaarikustannus	ˈelinˌkɑːriˌkustɑnːus
elinkeinoilmoitus	ˈelinˌkei̯noˌilmoi̯tus
elinkeinoverotus	ˈelinˌkei̯noˌʋerotus
elinluovuttaja	ˈelinˌluo̯ʋutːɑjɑ
elinsiirre	ˈelinˌsiːrːeˣ
elintarvikeinsinööri	ˈelinˌtɑrʋikeˣˌinsinøːri
elintarvikepolitiikka	ˈelinˌtɑrʋikeˣˌpolitiːkːɑ
elintarvikevalvonta	ˈelinˌtɑrʋikeˣˌʋɑlʋontɑ
elintensiirto	ˈelintenˌsiːrto
elisio	ˈelisio
elki	ˈelki
ellottaa	ˈelːotːɑːˣ
elohopeaseos	ˈeloˌhopeɑˌseos
elokuvaesitys	ˈeloˌkuʋɑˌesitys
elokuvalippu	ˈeloˌkuʋɑˌlipːu
elokuvapolitiikka	ˈeloˌkuʋɑˌpolitiːkːɑ
elokuvaus	ˈeloˌkuʋɑus
elonkorjuujuhla	ˈelonˌkorjuːˌjuhlɑ
eloonjäänyt	ˈeloːnˌjæːnyt
elpymisaika	ˈelpymisˌɑi̯kɑ
eluoida	ˈeluoi̯dɑˣ
elytra	ˈelytrɑ
eläinfysiologia	ˈelæi̯nˌfysioˌloɡiɑ
eläinlääke	ˈelæi̯nˌlæːkeˣ
eläinnäyttely	ˈelæi̯nˌnæy̯tːely
eläinpsykologi	ˈelæi̯n.psykoloɡi
eläinruno	ˈelæi̯nˌruno
eläinsuojeluvalvoja	ˈelæi̯nˌsuo̯jeluˌʋɑlʋojɑ
eläintensuojelu	ˈelæi̯ntenˌsuo̯jelu
eläkejärjestelmä	ˈelækeˣˌjærjestelmæ
eläkesäätiö	ˈelækeˣˌsæːtiø
eläköityminen	ˈelækøi̯tyminen
elämyspohja	ˈelæmysˌpohjɑ
elämänalue	ˈelæmænˌɑlueˣ
elämänilmiö	ˈelæmænˌilmiø
elämänkerrallinen	ˈelæmænˌkerːɑlːinen
elämänkumppani	ˈelæmænˌkumpːɑni
elämänmyönteisesti	ˈelæmænˌmyø̯ntei̯sestiˣ
elämäntaistelu	ˈelæmænˌtɑi̯stelu
elämäntyyli	ˈelæmænˌtyːli
elätettävä	ˈelætetːæʋæ
elävästi	ˈelæʋæstiˣ
eläytyä	ˈelæy̯tyæˣ
emalitaide	ˈemɑliˌtɑi̯deˣ
emergenssi	ˈemerɡensːi
emiiri	ˈemiːri
emissiokurssi	ˈemisːioˌkursːi
emmental	ˈemːent(ː)ɑl
emokenno	ˈemoˌkenːo
empatiakykyinen	ˈempɑtiɑˌkykyi̯nen
emulgoitua	ˈemulɡoi̯tuɑˣ
emäksisesti	ˈemæksisestiˣ
emännöitseminen	ˈemænːøi̯tseminen
emäsryhmä	ˈemæsˌryhmæ
emävalhe	ˈemæˌʋɑlheˣ
endomorfinen	ˈendoˌmorfinen
enemmistövaali	ˈenemːistøˌʋɑːli
energetiikka	ˈenerɡetiːkːɑ
energiakomissaari	ˈenerɡiɑˌkomisːɑːri
energianeuvos	ˈenerɡiɑˌneu̯ʋos
energiantuotanto	ˈenerɡiɑnˌtuo̯tɑnto
energiasuunnittelija	ˈenerɡiɑˌsuːnːitːelijɑ
energiateknologia	ˈenerɡiɑˌteknoloɡiɑ
energiayhtiö	ˈenerɡiɑˌyhtiø
englanninraiheinä	ˈeŋlɑnːinˌrɑi̯ˌhei̯næ
englantilaismies	ˈeŋlɑntilɑi̯sˌmie̯s
enimmäishinta	ˈenimːæi̯sˌhintɑ
enimmältään	ˈenimːæltæːn
enkelinkiharat	ˈeŋkelinˌkihɑrɑt
enkooderi	ˈeŋkoːderi
ennakkoesitys	ˈenːɑkːoˌesitys
ennakkomainostus	ˈenːɑkːoˌmɑi̯nostus
ennakkopäätös	ˈenːɑkːoˌpæːtøs
ennakkotilaaja	ˈenːɑkːoˌtilɑːjɑ
ennakkovero	ˈenːɑkːoˌʋero
ennakolta	ˈenːɑkoltɑ
ennaltaehkäisevä	ˈenːɑltɑˌehkæi̯seʋæ
ennennäkemättömästi	ˈenːenˌnækemætːømæstiˣ
ennuste	ˈenːusteˣ
ennätyksellisyys	ˈenːætykselːisyːs
ennätyspaino	ˈenːætysˌpɑi̯no
enonkoskelainen	ˈenonˌkoskelɑi̯nen
ensiapu	ˈensiˌɑpu
ensiasunto	ˈensiˌɑsunto
ensikieli	ˈensiˌkie̯li
ensikäyttö	ˈensiˌkæy̯tːø
ensimmältä	ˈensimːæltæ
ensipäivänleima	ˈensiˌpæi̯ʋænˌlei̯mɑ
ensivaste	ˈensiˌʋɑsteˣ
ensiötutka	ˈensiøˌtutkɑ
enter	ˈent(ː)er
entistäjä	ˈentistæjæ
entomologia	ˈentomoloɡiɑ
entää	ˈentæːˣ
epidemiologia	ˈepidemioloɡiɑ
epigenomi	ˈepiˌɡenomi
epimeraasi	ˈepimerɑːsi
epiteelikudos	ˈepiteːliˌkudos
epäammattimainen	ˈepæˌɑmːɑtːiˌmɑi̯nen
epäidenttinen	ˈepæˌidentːinen
epäitsekäs	ˈepæˌitsekæs
epäkurantti	ˈepæˌkurɑntːi
epäoikeudenmukaisuus	ˈepæˌoi̯keu̯denˌmukɑi̯suːs
epäröimättä	ˈepærøi̯mætːæ
epäsuhtaisesti	ˈepæˌsuhtɑi̯sestiˣ
epätoivoissaan	ˈepæˌtoi̯ʋoi̯sːɑːn
epävarma	ˈepæˌʋɑrmɑ
erakkokuoriainen	ˈerɑkːoˌkuo̯riɑi̯nen
eraus	ˈerɑus
ergodinen	ˈerɡodinen
erheellisesti	ˈerheːlːisestiˣ
erikoisartikkeli	ˈerikoi̯sˌɑrtikːeli
erikoiskasvi	ˈerikoi̯sˌkɑsʋi
erikoislahjakas	ˈerikoi̯sˌlɑhjɑkɑs
erikoismaininta	ˈerikoi̯sˌmɑi̯nintɑ
erikoispuulaji	ˈerikoi̯sˌpuːˌlɑji
erikoistapaus	ˈerikoi̯sˌtɑpɑus
erikoistumisopinnot	ˈerikoi̯stumisˌopinːot
erikokoinen	ˈeriˌkokoi̯nen
erilaistuminen	ˈerilɑi̯stuminen
erillisselvitys	ˈerilːisˌselʋitys
erimallinen	ˈeriˌmɑlːinen
erinimisyys	ˈeriˌnimisyːs
eriparisuus	ˈeriˌpɑrisuːs
eriste	ˈeristeˣ
eristyshuone	ˈeristysˌhuo̯neˣ
eristäytyminen	ˈeristæy̯tyminen
erisäätyinen	ˈeriˌsæːtyi̯nen
erittely	ˈeritːely
erityisestävyys	ˈerityi̯sˌestæʋyːs
erityisliikunta	ˈerityi̯sˌliːkuntɑ
erityisruokavalio	ˈerityi̯sˌruo̯kɑˌʋɑlio
erityyppinen	ˈeriˌtyːpːinen
eriytyminen	ˈeriy̯tyminen
erkkeri	ˈerkːeri
eroaminen	ˈeroɑminen
erojaistilaisuus	ˈerojɑi̯sˌtilɑi̯suːs
erosuure	ˈeroˌsuːreˣ
erottamislausuma	ˈerotːɑmisˌlɑu̯sumɑ
erovuoroinen	ˈeroˌʋuo̯roi̯nen
eräajo	ˈeræˌɑjo
eräkäsittely	ˈeræˌkæsitːely
eränkäynti	ˈerænˌkæy̯nti
erätauko	ˈeræˌtɑu̯ko
esiin	ˈesiːn
esiintymisalue	ˈesiːntymisˌɑlueˣ
esiintymä	ˈesiːntymæ
esikisat	ˈesiˌkisɑt
esikuntakomppania	ˈesiˌkuntɑˌkompːɑniɑ
esiliite	ˈesiˌliːteˣ
esimerkillisyys	ˈesiˌmerkilːisyːs
esimurrosikä	ˈesiˌmurːosˌikæ
esineskanneri	ˈesineˣˌskɑnːeri
esipiha	ˈesiˌpihɑ
esisolu	ˈesiˌsolu
esitelmöidä	ˈesitelˌmøi̯dæˣ
esittäjä	ˈesitːæjæ
esitysgrafiikka	ˈesitysˌɡrɑfiːkːɑ
esityö	ˈesiˌtyø̯
eskaloida	ˈeskɑloi̯dɑˣ
eskimokielinen	ˈeskimoˌkie̯linen
esoterismi	ˈesoterismi
essealainen	ˈesːeɑlɑi̯nen
essi	ˈesːi
esteellinen	ˈesteːlːinen
estely	ˈestely
esto	ˈesto
estyneisyys	ˈestynei̯syːs
etakryynihappo	ˈetɑkryːniˌhɑpːo
eteenpäinmeno	ˈeteːnˌpæi̯nˌmeno
eteisvärinä	ˈetei̯sˌʋærinæ
eteläamerikanlokki	ˈetelæˌɑmerikɑnˌlokːi
etelämpänä	ˈetelæmpænæ
etelänlepakko	ˈetelænˌlepɑkːo
eteläpuolitse	ˈetelæˌpuo̯litseˣ
etemmäksi	ˈetemːæksi
etenemisvaihe	ˈetenemisˌʋɑi̯heˣ
etikka	ˈetikːɑ
etioloituminen	ˈetioloi̯tuminen
etnografia	ˈetnoˌɡrɑfiɑ
etnomusikologia	ˈetnomusikoloɡiɑ
etruskipäästäinen	ˈetruskiˌpæːstæi̯nen
etsintäpalvelu	ˈetsintæˌpɑlʋelu
etuaivot	ˈetuˌɑi̯ʋot
etuhele	ˈetuˌheleˣ
etukautta	ˈetuˌkɑu̯tːɑ
etukäpälä	ˈetuˌkæpælæ
etulyönti	ˈetuˌlyø̯nti
etunolla	ˈetuˌnolːɑ
etuosto-oikeus	ˈetuˌostoˌ(ʔ)oi̯keus
etupiiri	ˈetuˌpiːri
etupäivystäjä	ˈetuˌpæi̯ʋystæjæ
eturyhmä	ˈetuˌryhmæ
etutasapaino	ˈetuˌtɑsɑˌpɑi̯no
etuvalo	ˈetuˌʋɑlo
etuvasempaan	ˈetuˌʋɑsempɑːn
etähoito	ˈetæˌhoi̯to
etäkauppa	ˈetæˌkɑu̯pːɑ
etäopiskelija	ˈetæˌopiskelijɑ
etätunnistaminen	ˈetæˌtunːistɑminen
etäämpää	ˈetæːmpæː
euforia	ˈeu̯foriɑ
euro-	ˈeu̯ro-
evankelioiminen	ˈeʋɑŋkelioi̯minen
evijärveläinen	ˈeʋijærʋelæi̯nen
eväste	ˈeʋæsteˣ
faagiterapia	ˈfɑːɡiˌterɑpiɑ
fabriikki	ˈfɑbriːkːi
fagottikonsertto	ˈfɑɡotːiˌkonsertːo
faktantarkistaja	ˈfɑktɑnˌtɑrkistɑjɑ
falsifikationismi	ˈfɑlsifikɑtionismi
faniklubi	ˈfɑniˌklubi
fantomisärky	ˈfɑntomiˌsærky
farmarihousut	ˈfɑrmɑriˌhou̯sut
fasismi	ˈfɑsismi
favismi	ˈfɑʋismi
femakko	ˈfemɑkːo
fennistiikka	ˈfenːistiːkːɑ
fermentointi	ˈfermentoi̯nti
fetofetaalinen	ˈfetoˌfetɑːlinen
fii	ˈfiː
fiksata	ˈfiksɑtɑˣ
filiaali	ˈfiliɑːli
filmatisoida	ˈfilmɑtisoi̯dɑˣ
filtraus	ˈfiltrɑus
finni	ˈfinːi
flaami	ˈflɑːmi
flanelli	ˈflɑnelːi
flikka	ˈflikːɑ
floppi	ˈflopːi
fluori	ˈfluo̯ri
flyygeli	ˈflyːɡeli
fonaatio	ˈfonɑːtio
fonologi	ˈfonoloɡi
forensinen	ˈforensinen
fosfolipaasi	ˈfosfolipɑːsi
fotobiologia	ˈfotoˌbioloɡiɑ
fotosynteesi	ˈfotoˌsynteːsi
franchise	ˈfræntʃɑi̯s
freegani	ˈfreːɡɑni
friisi	ˈfriːsi
fronto-	ˈfronto-
ftaalihappo	ˈftɑːliˌhɑpːo
fulani	ˈfulɑni
funikulaari	ˈfunikulɑːri
fusionaalinen	ˈfusionɑːlinen
fuuga	ˈfuːɡɑ
fysiokraatti	ˈfysiokrɑːtːi
fäärinkielinen	ˈfæːrinˌkie̯linen
fööni	ˈføːni
galapagosinmerileijona	ˈɡɑlɑpɑɡosinˌmeriˌlei̯jonɑ
galliinihappo	ˈɡɑlːiːniˌhɑpːo
gametofyyttinen	ˈɡɑmetoˌfyːtːinen
ganglio	ˈɡɑŋlio
gastrointestinaalinen	ˈɡɑstroˌintestinɑːlinen
geenimanipuloitu	ˈɡeːniˌmɑnipuloi̯tu
geigermittari	ˈɡɑi̯ɡerˌmitːɑri
gemssi	ˈɡemsːi
generalisti	ˈɡenerɑlisti
gens	ˈɡens
geoidi	ˈɡeoi̯di
geomorfologi	ˈɡeoˌmorfoloɡi
geotekninen	ˈɡeoˌtekninen
geronomi	ˈɡeronomi
getto	ˈɡetːo
giga-	ˈɡiɡɑ-
gini	ˈɡini
glaukooma	ˈɡlɑu̯koːmɑ
globalisoituminen	ˈɡlobɑlisoi̯tuminen
gluoni	ˈɡluo̯ni
glykosidaasi	ˈɡlykoˌsidɑːsi
glögi	ˈɡløɡi
golf	ˈɡolf
gonorrea	ˈɡonorːeɑ
gospel	ˈɡospel
gradu	ˈɡrɑdu
grammari	ˈɡrɑmːɑri
grandiositeetti	ˈɡrɑndiositeːtːi
gravis	ˈɡrɑ(ː)ʋis
grenadiini	ˈɡrenɑdiːni
grivna	ˈɡriʋnɑ
grönlanninlokki	ˈɡrønlɑnːinˌlokːi
gueretsa	ˈɡueretsɑ
guyanalainen	ˈɡujɑnɑlɑi̯nen
gyroskooppi	ˈɡyroˌskoːpːi
haaksirikko	ˈhɑːksiˌrikːo
haamu	ˈhɑːmu
haapametsä	ˈhɑːpɑˌmetsæ
haarahyppy	ˈhɑːrɑˌhypːy
haarikko	ˈhɑːrikːo
haarukoiminen	ˈhɑːrukoi̯minen
haastaja	ˈhɑːstɑjɑ
haava	ˈhɑːʋɑ
haavoittaa	ˈhɑːʋoi̯tːɑːˣ
haggis	ˈhɑɡːis
hahmosuunnittelu	ˈhɑhmoˌsuːnːitːelu
haihdutin	ˈhɑi̯hdutin
haikala	ˈhɑi̯ˌkɑlɑ
haimatulehdus	ˈhɑi̯mɑˌtulehdus
haista paska	ˈhɑi̯stɑˣ ˈpɑskɑ
haistella	ˈhɑi̯stelːɑˣ
haitariovi	ˈhɑi̯tɑriˌoʋi
haittalevy	ˈhɑi̯tːɑˌleʋy
hajaannuttaa	ˈhɑjɑːnːutːɑːˣ
hajallaan	ˈhɑjɑlːɑːn
hajasaantimuisti	ˈhɑjɑˌsɑːntiˌmui̯sti
hajataittoisuus	ˈhɑjɑˌtɑi̯tːoi̯suːs
hajautusarvo	ˈhɑjɑu̯tusˌɑrʋo
hajoava	ˈhɑjoɑʋɑ
hajottaa	ˈhɑjotːɑːˣ
hajuaistimus	ˈhɑjuˌɑi̯stimus
hajuvesikauppa	ˈhɑjuˌʋesiˌkɑu̯pːɑ
hakarauta	ˈhɑkɑˌrɑu̯tɑ
hakeminen	ˈhɑkeminen
hakkaaminen	ˈhɑkːɑːminen
hakkuriteholähde	ˈhɑkːuriˌtehoˌlæhdeˣ
hakkuukertymä	ˈhɑkːuːˌkertymæ
hakkuusuunnite	ˈhɑkːuːˌsuːnːiteˣ
haku	ˈhɑku
hakukone	ˈhɑkuˌkoneˣ
hakuprofiili	ˈhɑkuˌprofiːli
hakuvalo	ˈhɑkuˌʋɑlo
halia	ˈhɑliɑˣ
halkaiseminen	ˈhɑlkɑi̯seminen
halkihuuli	ˈhɑlkiˌhuːli
halkometsä	ˈhɑlkoˌmetsæ
hallamittari	ˈhɑlːɑˌmitːɑri
hallikauppa	ˈhɑlːiˌkɑu̯pːɑ
hallinnoija	ˈhɑlːinːoi̯jɑ
hallinto-oikeus	ˈhɑlːintoˌ(ʔ)oi̯keus
hallintokaupunki	ˈhɑlːintoˌkɑu̯puŋki
hallintomuoto	ˈhɑlːintoˌmuo̯to
hallintosihteeri	ˈhɑlːintoˌsihteːri
hallintoviranomainen	ˈhɑlːintoˌʋirɑnˌomɑi̯nen
hallitsijanimi	ˈhɑlːitsijɑˌnimi
hallitusherra	ˈhɑlːitusˌherːɑ
hallitusmielisesti	ˈhɑlːitusˌmie̯lisestiˣ
hallitustenvälinen	ˈhɑlːitustenˌʋælinen
hallu	ˈhɑlːu
hallussapitorikos	ˈhɑlːusːɑˌpitoˌrikos
halolamppu	ˈhɑloˌlɑmpːu
halpa-arvoinen	ˈhɑlpɑˌ(ʔ)ɑrʋoi̯nen
halpamielisyys	ˈhɑlpɑˌmie̯lisyːs
halstraaminen	ˈhɑlstrɑːminen
haltioihinsa	ˈhɑltioi̯hinsɑˣ
haluaminen	ˈhɑluɑminen
halvasti	ˈhɑlʋɑstiˣ
halveksua	ˈhɑlʋeksuɑˣ
hamara	ˈhɑmɑrɑ
haminalainen	ˈhɑminɑlɑi̯nen
hammasjako	ˈhɑmːɑsˌjɑko
hammaskulta	ˈhɑmːɑsˌkultɑ
hammaspihdit	ˈhɑmːɑsˌpihdit
hammassuojus	ˈhɑmːɑsˌsuo̯jus
hammastekniikka	ˈhɑmːɑsˌtekniːkːɑ
hammasvälitys	ˈhɑmːɑsˌʋælitys
hampaanpoisto	ˈhɑmpɑːnˌpoi̯sto
hampunsiemen	ˈhɑmpunˌsie̯men
han-kiinalainen	ˈhɑnˌkiːnɑlɑi̯nen
haneen	ˈhɑneːn
hanhenmaksa	ˈhɑnhenˌmɑksɑ
hanhikukko	ˈhɑnhiˌkukːo
hankajalkainen	ˈhɑŋkɑˌjɑlkɑi̯nen
hankaussähkö	ˈhɑŋkɑusˌsæhkø
hankevienti	ˈhɑŋkeˣˌʋie̯nti
hankintakauppa	ˈhɑŋkintɑˌkɑu̯pːɑ
hankkia	ˈhɑŋkːiɑˣ
hansikaskauppa	ˈhɑnsikɑsˌkɑu̯pːɑ
hapankaali	ˈhɑpɑnˌkɑːli
hapannuttaminen	ˈhɑpɑnːutːɑminen
hapatin	ˈhɑpɑtin
hapenottokyky	ˈhɑpenˌotːoˌkyky
hapettaminen	ˈhɑpetːɑminen
hapoinen	ˈhɑpoi̯nen
happamoitua	ˈhɑpːɑmoi̯tuɑˣ
happikato	ˈhɑpːiˌkɑto
happiradikaali	ˈhɑpːiˌrɑdikɑːli
happoanhydridi	ˈhɑpːoˌɑnhydridi
hapsisara	ˈhɑpsiˌsɑrɑ
harajuuri	ˈhɑrɑˌjuːri
haralle	ˈhɑrɑlːeˣ
haravoitseminen	ˈhɑrɑʋoi̯tseminen
harhaisuus	ˈhɑrhɑi̯suːs
harhaoppi	ˈhɑrhɑˌopːi
harhateiltä	ˈhɑrhɑˌtei̯ltæ
haristua	ˈhɑristuɑˣ
harjaantumattomuus	ˈhɑrjɑːntumɑtːomuːs
harjakattoinen	ˈhɑrjɑˌkɑtːoi̯nen
harjalammas	ˈhɑrjɑˌlɑmːɑs
harjaorsi	ˈhɑrjɑˌorsi
harjasheinä	ˈhɑrjɑsˌhei̯næ
harjoittelukoulu	ˈhɑrjoi̯tːeluˌkou̯lu
harjoituskirja	ˈhɑrjoi̯tusˌkirjɑ
harjoitustyö	ˈhɑrjoi̯tusˌtyø̯
harjuslauta	ˈhɑrjusˌlɑu̯tɑ
harkitsevaisuus	ˈhɑrkitseʋɑi̯suːs
harkkorauta	ˈhɑrkːoˌrɑu̯tɑ
harmaakaihi	ˈhɑrmɑːˌkɑi̯hi
harmaakylkimonninen	ˈhɑrmɑːˌkylkiˌmonːinen
harmaaorvakka	ˈhɑrmɑːˌorʋɑkːɑ
harmaasieppo	ˈhɑrmɑːˌsie̯pːo
harmaatukkainen	ˈhɑrmɑːˌtukːɑi̯nen
harmi	ˈhɑrmi
harmittaa	ˈhɑrmitːɑːˣ
harmoninen keskiarvo	ˈhɑrmoninen ˈkeskiˌɑrʋo
harpunkieli	ˈhɑrpunˌkie̯li
harrastajataiteilija	ˈhɑrːɑstɑjɑˌtɑi̯tei̯lijɑ
harrastuneisuus	ˈhɑrːɑstunei̯suːs
harsimalanka	ˈhɑrsimɑˌlɑŋkɑ
harsopilvi	ˈhɑrsoˌpilʋi
hartauspuhe	ˈhɑrtɑusˌpuheˣ
hartianseutu	ˈhɑrtiɑnˌseu̯tu
hartsiliima	ˈhɑrtsiˌliːmɑ
harva	ˈhɑrʋɑ
harvalukuinen	ˈhɑrʋɑˌlukui̯nen
harvasanaisuus	ˈhɑrʋɑˌsɑnɑi̯suːs
harventuminen	ˈhɑrʋentuminen
hassutteleminen	ˈhɑsːutːeleminen
hattu-z	ˈhɑtːuˌtset(ɑ)
hattuteline	ˈhɑtːuˌtelineˣ
hatuttaa	ˈhɑtutːɑːˣ
haude	ˈhɑu̯deˣ
hauduke	ˈhɑu̯dukeˣ
haukahdus	ˈhɑu̯kɑhdus
haukiputaalainen	ˈhɑu̯kiˌputɑːˌlɑi̯nen
haukkoja	ˈhɑu̯kːojɑ
haukkupanta	ˈhɑu̯kːuˌpɑntɑ
haulikkorihla	ˈhɑu̯likːoˌrihlɑ
haurasrakenteinen	ˈhɑu̯rɑsˌrɑkentei̯nen
hauskuttaa	ˈhɑu̯skutːɑːˣ
hauta	ˈhɑu̯tɑ
hautakalusto	ˈhɑu̯tɑˌkɑlusto
hautapaasi	ˈhɑu̯tɑˌpɑːsi
hautausmenot	ˈhɑu̯tɑusˌmenot
hautomalaikku	ˈhɑu̯tomɑˌlɑi̯kːu
havainnoida	ˈhɑʋɑi̯nːoi̯dɑˣ
havaita	ˈhɑʋɑi̯tɑˣ
havukirves	ˈhɑʋuˌkirʋes
hašiš	ˈhɑʃiʃ
heavyrock	ˈheʋiˌrokːi
hedelmäkaramelli	ˈhedelmæˌkɑrɑmelːi
hedelmämalto	ˈhedelmæˌmɑlto
hedelmäsuola	ˈhedelmæˌsuo̯lɑ
hedelmöittävä	ˈhedelmøi̯tːæʋæ
heh	ˈheh
hehkusytytys	ˈhehkuˌsytytys
heidänlaisensa	ˈhei̯dænˌlɑi̯sensɑˣ
heijastin	ˈhei̯jɑstin
heijastuskulma	ˈhei̯jɑstusˌkulmɑ
heikentyminen	ˈhei̯kentyminen
heikkomielisyys	ˈhei̯kːoˌmie̯lisyːs
heikkovoima	ˈhei̯kːoˌʋoi̯mɑ
heikun keikun	ˈhei̯kun ˈkei̯kun
heilastaa	ˈhei̯lɑstɑːˣ
heilimöinti	ˈhei̯limøi̯nti
heimo	ˈhei̯mo
heimosoturi	ˈhei̯moˌsoturi
heinähäkki	ˈhei̯næˌhækːi
heinämaa	ˈhei̯næˌmɑː
heinänsiemen	ˈhei̯nænˌsie̯men
heinäsuova	ˈhei̯næˌsuo̯ʋɑ
heinävuosi	ˈhei̯næˌʋuo̯si
heitteillejättö	ˈhei̯tːei̯lːeˣˌjætːø
heittokuutio	ˈhei̯tːoˌkuːtio
heittouistin	ˈhei̯tːoˌui̯stin
heittäytyä	ˈhei̯tːæy̯tyæˣ
hekotus	ˈhekotus
helahoito	ˈhelɑˌhoi̯to
helatorstai	ˈhelɑˌtorstɑi̯
heleänkeltainen	ˈheleænˌkeltɑi̯nen
helikopterionnettomuus	ˈhelikopteriˌonːetːomuːs
helistää	ˈhelistæːˣ
helkytellä	ˈhelkytelːæˣ
hellapuu	ˈhelːɑˌpuː
hellesää	ˈhelːeˣˌsæː
hellittämättömästi	ˈhelːitːæmætːømæstiˣ
hellyttää	ˈhelːytːæːˣ
helläkätinen	ˈhelːæˌkætinen
hellätunteisesti	ˈhelːæˌtuntei̯sestiˣ
helmenpyynti	ˈhelmenˌpyːnti
helmihopeatäplä	ˈhelmiˌhopeɑˌtæplæ
helmililja	ˈhelmiˌliljɑ
helmipuuro	ˈhelmiˌpuːro
helmiäishohtoinen	ˈhelmiæi̯sˌhohtoi̯nen
heloittaminen	ˈheloi̯tːɑminen
helpontaa	ˈhelpontɑːˣ
helppoheikki	ˈhelpːoˌhei̯kːi
helppopääsyinen	ˈhelpːoˌpæːsyi̯nen
helskytys	ˈhelskytys
heltyä	ˈheltyæˣ
hemangiooma	ˈhemɑŋːioːmɑ
hemmetinmoinen	ˈhemːetinˌmoi̯nen
hempeämielinen	ˈhempeæˌmie̯linen
hengenelämä	ˈheŋːenˌelæmæ
hengenpelastusmitali	ˈheŋːenˌpelɑstusˌmitɑl(ː)i
hengettömästi	ˈheŋːetːømæstiˣ
hengitysharjoitus	ˈheŋːitysˌhɑrjoi̯tus
hengitystaajuus	ˈheŋːitysˌtɑːjuːs
hengästyttävä	ˈheŋːæstytːæʋæ
henkevöityä	ˈheŋkeʋøi̯tyæˣ
henkikirja	ˈheŋkiˌkirjɑ
henkilöhahmo	ˈheŋkiløˌhɑhmo
henkilöjäsen	ˈheŋkiløˌjæsen
henkilökuntalehti	ˈheŋkiløˌkuntɑˌlehti
henkilönimi	ˈheŋkiløˌnimi
henkilötakaus	ˈheŋkiløˌtɑkɑus
henkilövalinta	ˈheŋkiløˌʋɑlintɑ
henkitiede	ˈheŋkiˌtie̯deˣ
henkivakuutusyhtiö	ˈheŋkiˌʋɑkuːtusˌyhtiø
henkäys	ˈheŋkæys
hentosara	ˈhentoˌsɑrɑ
hepatopulmonaarinen	ˈhepɑtoˌpulmonɑːrinen
heppoisesti	ˈhepːoi̯sestiˣ
hepuli	ˈhepuli
herbartilaisuus	ˈherbɑrtilɑi̯suːs
heristys	ˈheristys
herjata	ˈherjɑtɑˣ
herkeämätön	ˈherkeæmætøn
herkkä	ˈherkːæ
herkkätunteisesti	ˈherkːæˌtuntei̯sestiˣ
hermanni	ˈhermɑnːi
hermoheikko	ˈhermoˌhei̯kːo
hermoliitos	ˈhermoˌliːtos
hermosto	ˈhermosto
hermostunut	ˈhermostunut
hermoton	ˈhermoton
herne	ˈherneˣ
hernepelto	ˈherneˣˌpelto
heroiiniriippuvainen	ˈheroi̯ːniˌriːpːuʋɑi̯nen
herpetologia	ˈherpetoloɡiɑ
herrajesta	ˈherːɑˌjestɑ
herraskartano	ˈherːɑsˌkɑrtɑno
herrnhutilainen	ˈherːnhutilɑi̯nen
herttaisesti	ˈhertːɑi̯sestiˣ
herukkapensas	ˈherukːɑˌpensɑs
hervottomasti	ˈherʋotːomɑstiˣ
heräteosto	ˈheræteˣˌosto
herätystyö	ˈherætysˌtyø̯
heteroseksuaali	ˈheteroˌseksuɑːli
hetki	ˈhetki
hetu	ˈhetu
hevimusa	ˈheʋiˌmusɑ
hevosenkenkäkaari	ˈheʋosenˌkeŋkæˌkɑːri
hevosjalostus	ˈheʋosˌjɑlostus
hevoskuormallinen	ˈheʋosˌkuo̯rmɑlːinen
hevospuomi	ˈheʋosˌpuo̯mi
hevosurheilu	ˈheʋosˌurhei̯lu
hidaskäyntinen	ˈhidɑsˌkæy̯ntinen
hidastetöyssy	ˈhidɑsteˣˌtøy̯sːy
hie	ˈhie̯ˣ
hiekkaerämaa	ˈhie̯kːɑˌeræˌmɑː
hiekkakuoppa	ˈhie̯kːɑˌkuo̯pːɑ
hiekkanummi	ˈhie̯kːɑˌnumːi
hiekkapohjainen	ˈhie̯kːɑˌpohjɑi̯nen
hiekkatörmä	ˈhie̯kːɑˌtørmæ
hieno	ˈhie̯no
hienolaatuinen	ˈhie̯noˌlɑːtui̯nen
hienontaa	ˈhie̯nontɑːˣ
hienorakeinen	ˈhie̯noˌrɑkei̯nen
hienosto	ˈhie̯nosto
hienotunteisuus	ˈhie̯notuntei̯suːs
hierarkkinen	ˈhie̯rɑrkːinen
hieronta	ˈhie̯rontɑ
hiertymä	ˈhie̯rtymæ
hiesusavi	ˈhie̯suˌsɑʋi
hietamato	ˈhie̯tɑˌmɑto
hievahdus	ˈhie̯ʋɑhdus
hihhuli	ˈhihːuli
hihna-avokas	ˈhihnɑˌ(ʔ)ɑʋokɑs
hiihdin	ˈhiːhdin
hiihtoesteratsastus	ˈhiːhtoˌesteˣˌrɑtsɑstus
hiihtokuningas	ˈhiːhtoˌkuniŋːɑs
hiihtomaja	ˈhiːhtoˌmɑjɑ
hiihtosuunnistus	ˈhiːhtoˌsuːnːistus
hiilari	ˈhiːlɑri
hiiletys	ˈhiːletys
hiilidioksidipitoisuus	ˈhiːliˌdioksidiˌpitoi̯suːs
hiiliharja	ˈhiːliˌhɑrjɑ
hiilikuitumaila	ˈhiːliˌkui̯tuˌmɑi̯lɑ
hiilimurska	ˈhiːliˌmurskɑ
hiilipöly	ˈhiːliˌpøly
hiilivety	ˈhiːliˌʋety
hiilusta	ˈhiːlustɑ
hiippakuntasihteeri	ˈhiːpːɑˌkuntɑˌsihteːri
hiirenhäntä	ˈhiːrenˌhæntæ
hiiriopossumi	ˈhiːriˌoposːumi
hiivaleipäjauho	ˈhiːʋɑˌlei̯pæˌjɑu̯ho
hiiviskelypeli	ˈhiːʋiskelyˌpeli
hikihihna	ˈhikiˌhihnɑ
hikipisara	ˈhikiˌpisɑrɑ
hikke	ˈhikːe
hila	ˈhilɑ
hiljaa	ˈhiljɑː
hiljemmällä	ˈhiljemːælːæ
hillottaa	ˈhilːotːɑːˣ
hima	ˈhimɑ
himmentäminen	ˈhimːentæminen
himomurha	ˈhimoˌmurhɑ
himpun	ˈhimpun
hinauttaminen	ˈhinɑutːɑminen
hinkuminen	ˈhiŋkuminen
hinnanmuutos	ˈhinːɑnˌmuːtos
hinnoitus	ˈhinːoi̯tus
hintakehitys	ˈhintɑˌkehitys
hintasäännöstely	ˈhintɑˌsæːnːøstely
hintavalvonta	ˈhintɑˌʋɑlʋontɑ
hinttiys	ˈhintːiys
hiomalaikka	ˈhiomɑˌlɑi̯kːɑ
hiostaa	ˈhiostɑːˣ
hioutuneisuus	ˈhiou̯tunei̯suːs
hipihiljaa	ˈhipiˌhiljɑː
hippalot	ˈhipːɑlot
hippokampus	ˈhipːoˌkɑmp(ː)us
hipsuttelu	ˈhipsutːelu
hirmukunto	ˈhirmuˌkunto
hirnuminen	ˈhirnuminen
hirsikoulu	ˈhirsiˌkou̯lu
hirssisara	ˈhirsːiˌsɑrɑ
hirttäjä	ˈhirtːæjæ
hirvenjäkälä	ˈhirʋenˌjækælæ
hirvensarvensuola	ˈhirʋenˌsɑrʋenˌsuo̯lɑ
hirveys	ˈhirʋeys
hirvipaisti	ˈhirʋiˌpɑi̯sti
hirvivahinko	ˈhirʋiˌʋɑhiŋko
hissi	ˈhisːi
hissuksiin	ˈhisːuksiːn
histologinen	ˈhistoˌloɡinen
historiankäsitys	ˈhistoriɑnˌkæsitys
historiatiede	ˈhistoriɑˌtie̯deˣ
hitaus	ˈhitɑus
hitsauskypärä	ˈhitsɑusˌkypæræ
hitsauspoltin	ˈhitsɑusˌpoltin
hitulautanen	ˈhituˌlɑu̯tɑnen
hiukkassuodatin	ˈhiu̯kːɑsˌsuo̯dɑtin
hiuksianostattava	ˈhiu̯ksiɑˌnostɑtːɑʋɑ
hiusjuuri	ˈhiu̯sˌjuːri
hiusmeduusa	ˈhiu̯sˌmeduːsɑ
hiusravinne	ˈhiu̯sˌrɑʋinːeˣ
hiustenpesu	ˈhiu̯stenˌpesu
hiusöljy	ˈhiu̯sˌøljy
hivellä	ˈhiʋelːæˣ
hm	m̩
hohkaa	ˈhohkɑːˣ
hohto	ˈhohto
hohtoviiripyrstö	ˈhohtoˌʋiːriˌpyrstø
hoikka	ˈhoi̯kːɑ
hoilata hoosiannaa	ˈhoi̯lɑtɑˣ ˈhoːsiɑnːɑ
hoitaja-potilassuhde	ˈhoi̯tɑjɑˌpotilɑsˌsuhdeˣ
hoitohenkilö	ˈhoi̯toˌheŋkilø
hoitola	ˈhoi̯tolɑ
hoitoonohjaus	ˈhoi̯toːnˌohjɑus
hoitotapa	ˈhoi̯toˌtɑpɑ
hoitovapaa	ˈhoi̯toˌʋɑpɑː
hoiva-ala	ˈhoi̯ʋɑˌ(ʔ)ɑlɑ
hoivaus	ˈhoi̯ʋɑus
hokki	ˈhokːi
holari	ˈholɑri
holhousyhteiskunta	ˈholhousˌyhtei̯sˌkuntɑ
holkkinasta	ˈholkːiˌnɑstɑ
hollolalainen	ˈholːolɑlɑi̯nen
holvaus	ˈholʋɑus
holvisto	ˈholʋisto
homekoulu	ˈhomeˣˌkou̯lu
hometalo	ˈhomeˣˌtɑlo
homobaari	ˈhomoˌbɑːri
homomorfia	ˈhomomorfiɑ
homotella	ˈhomotelːɑˣ
honka	ˈhoŋkɑ
honottaa	ˈhonotːɑːˣ
hoora	ˈhoːrɑ
hopeaharkko	ˈhopeɑˌhɑrkːo
hopeajuote	ˈhopeɑˌjuo̯teˣ
hopealejeerinki	ˈhopeɑˌlejeːriŋki
hopeanvalkoinen	ˈhopeɑnˌʋɑlkoi̯nen
hopeaseos	ˈhopeɑˌseos
hopeatilhi	ˈhopeɑˌtilhi
hopeoitua	ˈhopeoi̯tuɑˣ
hoputtaminen	ˈhoputːɑminen
horjuvainen	ˈhorjuʋɑi̯nen
hormonihäiriö	ˈhormo(ː)niˌhæi̯riø
horna	ˈhornɑ
horsma	ˈhorsmɑ
hostata	ˈhostɑtɑˣ
hotelliala	ˈhotelːiˌɑlɑ
hotellisekki	ˈhotelːiˌsekːi
hotsittaminen	ˈhotsitːɑminen
houkuttaminen	ˈhou̯kutːɑminen
hourailu	ˈhou̯rɑi̯lu
hourupää	ˈhou̯ruˌpæː
housupuku	ˈhou̯suˌpuku
hovimaalari	ˈhoʋiˌmɑːlɑri
hovisuru	ˈhoʋiˌsuru
huhmar	ˈhuhmɑr
huhuta	ˈhuhutɑˣ
huikata	ˈhui̯kɑtɑˣ
huikoa	ˈhui̯koɑˣ
huiluttaa	ˈhui̯lutːɑːˣ
huipentaa	ˈhui̯pentɑːˣ
huippujuttu	ˈhui̯pːuˌjutːu
huippulämpökeskus	ˈhui̯pːuˌlæmpøˌkeskus
huipputapaaminen	ˈhui̯pːuˌtɑpɑːminen
huippututkimus	ˈhui̯pːuˌtutkimus
huiputtaminen	ˈhui̯putːɑminen
huiskis	ˈhui̯skis
huitsin	ˈhui̯tsin
hujahdus	ˈhujɑhdus
hukka	ˈhukːɑ
hukkapala	ˈhukːɑˌpɑlɑ
hukkatyö	ˈhukːɑˌtyø̯
hukuttautua	ˈhukutːɑu̯tuɑˣ
hulina	ˈhulinɑ
hullunkurisuus	ˈhulːunˌkurisuːs
hulmahtaminen	ˈhulmɑhtɑminen
hulttiomainen	ˈhultːiomɑi̯nen
humahuttaa	ˈhumɑhutːɑːˣ
humaltua	ˈhumɑltuɑˣ
hummailu	ˈhumːɑi̯lu
humuspitoinen	ˈhumusˌpitoi̯nen
hunajaopas	ˈhunɑjɑˌopɑs
hunningolle	ˈhunːiŋːolːeˣ
huoahdus	ˈhuo̯ɑhdus
huojua	ˈhuo̯juɑˣ
huokeahintainen	ˈhuo̯keɑˌhintɑi̯nen
huolehtiva	ˈhuo̯lehtiʋɑ
huolestuminen	ˈhuo̯lestuminen
huolimatta	ˈhuo̯limɑtːɑ
huollettava	ˈhuo̯lːetːɑʋɑ
huoltohenkilöstö	ˈhuo̯ltoˌheŋkiløstø
huoltomuoto	ˈhuo̯ltoˌmuo̯to
huoltoupseeri	ˈhuo̯ltoˌupseːri
huomaamatta	ˈhuo̯mɑːmɑtːɑ
huomauttaminen	ˈhuo̯mɑutːɑminen
huomioida	ˈhuo̯mioi̯dɑˣ
huomiota herättävä	ˈhuo̯miotɑ ˈherætːæʋæ
huoneala	ˈhuo̯neˣˌɑlɑ
huonejärjestys	ˈhuo̯neˣˌjærjestys
huonekumipuu	ˈhuo̯neˣˌkumiˌpuː
huono	ˈhuo̯no
huonomuistisuus	ˈhuo̯noˌmui̯stisuːs
huonopäinen	ˈhuo̯noˌpæi̯nen
huonovointisuus	ˈhuo̯noˌʋoi̯ntisuːs
huopatossu	ˈhuo̯pɑˌtosːu
huoria	ˈhuo̯riɑˣ
huotra	ˈhuo̯trɑ
hupainen	ˈhupɑi̯nen
huppari	ˈhupːɑri
hupsista	ˈhupsistɑ
hurahdella	ˈhurɑhdelːɑˣ
huristeleminen	ˈhuristeleminen
hurjasteleminen	ˈhurjɑsteleminen
hurmahenki	ˈhurmɑˌheŋki
hurraa	ˈhurːɑː
hurstuthame	ˈhurstutˌhɑmeˣ
hutera	ˈhuterɑ
hutkia	ˈhutkiɑˣ
huudahduslause	ˈhuːdɑhdusˌlɑu̯seˣ
huuhdevesi	ˈhuːhdeˣˌʋesi
huuhtoutua	ˈhuːhtou̯tuɑˣ
huulikiille	ˈhuːliˌkiːlːeˣ
huulipuna	ˈhuːliˌpunɑ
huultaa	ˈhuːltɑːˣ
huumaus	ˈhuːmɑus
huumeinen	ˈhuːmei̯nen
huumepoliisi	ˈhuːmeˣˌpoliːsi
huumorimieli	ˈhuːmoriˌmie̯li
huurtuminen	ˈhuːrtuminen
huutista	ˈhuːtistɑ
huutokauppatilaisuus	ˈhuːtoˌkɑu̯pːɑˌtilɑi̯suːs
huutosakki	ˈhuːtoˌsɑkːi
huvialue	ˈhuʋiˌɑlueˣ
huvilakaupunki	ˈhuʋilɑˌkɑu̯puŋki
huvinäytelmä	ˈhuʋiˌnæy̯telmæ
huvittaminen	ˈhuʋitːɑminen
huviveneily	ˈhuʋiˌʋenei̯ly
hybridiorbitaali	ˈhybridiˌorbitɑːli
hydraulimoottori	ˈhydrɑu̯liˌmoːtːori
hydrografia	ˈhydroɡrɑfiɑ
hydrometeorologia	ˈhydrometeoroloɡiɑ
hygieniapaperi	ˈhyɡieniɑˌpɑperi
hyi	ˈhyi̯
hyljevene	ˈhyljeˣˌʋeneˣ
hylkäys	ˈhylkæys
hyllykorjain	ˈhylːyˌkorjɑi̯n
hylätty	ˈhylætːy
hymnografia	ˈhymnoˌɡrɑfiɑ
hymynhäivä	ˈhymynˌhæi̯ʋæ
hymähtäminen	ˈhymæhtæminen
hyperlinkki	ˈhyperˌliŋkːi
hypertensiivinen	ˈhyperˌtensiːʋinen
hypokondrisuus	ˈhypoˌkondrisuːs
hypoteesi	ˈhypoteːsi
hyppy	ˈhypːy
hyppylanka	ˈhypːyˌlɑŋkɑ
hyppyri	ˈhypːyri
hyppäyksellinen	ˈhypːæykselːinen
hyrrähaihdutin	ˈhyrːæˌhɑi̯hdutin
hyssytys	ˈhysːytys
hytti	ˈhytːi
hyttysöljy	ˈhytːysˌøljy
hyvitellä	ˈhyʋitelːæˣ
hyväenteinen	ˈhyʋæˌentei̯nen
hyväksikäyttää	ˈhyʋæksiˌkæy̯tːæːˣ
hyväksyä	ˈhyʋæksyæˣ
hyvänlaatuisuus	ˈhyʋænˌlɑːtui̯suːs
hyväntekeväisyysjuhla	ˈhyʋænˌtekeʋæi̯syːsˌjuhlɑ
hyväpalkkainen	ˈhyʋæˌpɑlkːɑi̯nen
hyvätuoksuinen	ˈhyʋæˌtuo̯ksui̯nen
hyy	ˈhyː
hyyry	ˈhyːry
hyödyke	ˈhyø̯dykeˣ
hyödytön	ˈhyø̯dytøn
hyökkäyskäsky	ˈhyø̯kːæysˌkæsky
hyökkäävyys	ˈhyø̯kːæːʋyːs
hyönteissuosija	ˈhyø̯ntei̯sˌsuo̯sijɑ
hyötyeläin	ˈhyø̯tyˌelæi̯n
hyötyosuus	ˈhyø̯tyˌosuːs
hädin tuskin	ˈhædin ˈtuskin
häijyys	ˈhæi̯jyːs
häilyväisyys	ˈhæi̯lyʋæi̯syːs
häirikkö	ˈhæi̯rikːø
häiritseminen	ˈhæi̯ritseminen
häiriösuojaus	ˈhæi̯riøˌsuo̯jɑus
häiriövirta	ˈhæi̯riøˌʋirtɑ
häivetekniikka	ˈhæi̯ʋeˣˌtekniːkːɑ
häkellyksiin	ˈhækelːyksiːn
häkkeri	ˈhækːeri
häkälöyly	ˈhækæˌløy̯ly
häly	ˈhæly
hälytyskeskus	ˈhælytysˌkeskus
hälytysääni	ˈhælytysˌæːni
hämillisyys	ˈhæmilːisyːs
hämmentävä	ˈhæmːentæʋæ
hämmästyttävästi	ˈhæmːæstytːæʋæstiˣ
hämäläinen	ˈhæmælæi̯nen
hämäräkytkin	ˈhæmæræˌkytkin
hämäännyksissä	ˈhæmæːnːyksisːæ
hännystakki	ˈhænːysˌtɑkːi
häntäjouhi	ˈhæntæˌjou̯hi
häpeä	ˈhæpeæ
häppä	ˈhæpːæ
härkä	ˈhærkæ
härkäpää	ˈhærkæˌpæː
härmä	ˈhærmæ
härpäke	ˈhærpækeˣ
häränleike	ˈhærænˌlei̯keˣ
häröily	ˈhærøi̯ly
hätimmiten	ˈhætimːiten
hätyyttäminen	ˈhætyːtːæminen
hätäilemättömyys	ˈhætæi̯lemætːømyːs
hätäjarru	ˈhætæˌjɑrːu
hätäleipä	ˈhætæˌlei̯pæ
hätäpysäytin	ˈhætæˌpysæy̯tin
hätätarve	ˈhætæˌtɑrʋeˣ
hätävarjelus	ˈhætæˌʋɑrjelus
hävitellä	ˈhæʋitelːæˣ
hävitysoperaattori	ˈhæʋitysˌoperɑːtːori
hävyntunne	ˈhæʋynˌtunːeˣ
hääkansa	ˈhæːˌkɑnsɑ
häämöttää	ˈhæːmøtːæːˣ
häätalo	ˈhæːˌtɑlo
hääyö	ˈhæːˌyø̯
hölkkä	ˈhølkːæ
hölkötellä	ˈhølkøtelːæˣ
höllälle	ˈhølːælːeˣ
hölmöily	ˈhølmøi̯ly
hömelö	ˈhømelø
höntsätä	ˈhøntsætæˣ
höperösti	ˈhøperøstiˣ
höpsö	ˈhøpsø
hörhelö	ˈhørhelø
hörtsö	ˈhørtsø
höröttäminen	ˈhørøtːæminen
höttösissään	ˈhøtːøsisːæːn
höyhentuppi	ˈhøy̯henˌtupːi
höykytys	ˈhøy̯kytys
höylätavara	ˈhøy̯læˌtɑʋɑrɑ
höyryjarru	ˈhøy̯ryˌjɑrːu
höyrylotja	ˈhøy̯ryˌlotjɑ
höyryradio	ˈhøy̯ryˌrɑdio
höyryttäminen	ˈhøy̯rytːæminen
höysteinen	ˈhøy̯stei̯nen
iankaikkinen	ˈiɑnˌkɑi̯kːinen
ideaalikaasulaki	ˈideɑːliˌkɑːsuˌlɑki
idempi	ˈidempi
ideografinen	ˈideoˌɡrɑfinen
idiopaattinen	ˈidiopɑːtːinen
idänpikkuliitäjä	ˈidænˌpikːuˌliːtæjæ
idänvienti	ˈidænˌʋie̯nti
ignoorata	ˈiɡnoːrɑtɑˣ
ihanasti	ˈihɑnɑstiˣ
ihannetapaus	ˈihɑnːeˣˌtɑpɑus
ihastuksissaan	ˈihɑstuksisːɑːn
ihmeellinen	ˈihmeːlːinen
ihmeolento	ˈihmeˣˌolento
ihmettyä	ˈihmetːyæˣ
ihmisarvo	ˈihmisˌɑrʋo
ihmishenki	ˈihmisˌheŋki
ihmiskoe	ˈihmisˌkoeˣ
ihmisluonne	ˈihmisˌluo̯nːeˣ
ihmismäisesti	ˈihmismæi̯sestiˣ
ihmisolento	ˈihmisˌolento
ihmissuhdekasvatus	ˈihmisˌsuhdeˣˌkɑsʋɑtus
ihmistuntemus	ˈihmisˌtuntemus
ihmisvoima	ˈihmisˌʋoi̯mɑ
ihoalue	ˈihoˌɑlueˣ
ihomaali	ˈihoˌmɑːli
ihonpuhdistus	ˈihonˌpuhdistus
ihottuma	ˈihotːumɑ
ii	ˈiː
iittiläinen	ˈiːtːilæi̯nen
ikaalislainen	ˈikɑːlislɑi̯nen
ikilinkki	ˈikiˌliŋkːi
ikkuna-aukko	ˈikːunɑˌ(ʔ)ɑu̯kːo
ikkunankuivain	ˈikːunɑnˌkui̯ʋɑi̯n
ikkunaristikko	ˈikːunɑˌristikːo
ikoninurkka	ˈikoniˌnurkːɑ
ikuisuus	ˈikui̯suːs
ikäkausi	ˈikæˌkɑu̯si
ikämiesmestaruus	ˈikæˌmie̯sˌmestɑruːs
ikäryhmätarkastus	ˈikæˌryhmæˌtɑrkɑstus
ikävystyttävä	ˈikæʋystytːæʋæ
ilahduttava	ˈilɑhdutːɑʋɑ
iljettävä	ˈiljetːæʋæ
ilkikurinen	ˈilkiˌkurinen
ilkosilleen	ˈilkosilːeːn
illanistujaiset	ˈilːɑnˌistujɑi̯set
illempana	ˈilːempɑnɑ
ilma	ˈilmɑ
ilmahuokonen	ˈilmɑˌhuo̯konen
ilmailuviranomainen	ˈilmɑi̯luˌʋirɑnˌomɑi̯nen
ilmaispalvelu	ˈilmɑi̯sˌpɑlʋelu
ilmaisunvapaus	ˈilmɑi̯sunˌʋɑpɑus
ilmajarru	ˈilmɑˌjɑrːu
ilmajuuri	ˈilmɑˌjuːri
ilmakitara	ˈilmɑˌkitɑrɑ
ilmaliikennejuopumus	ˈilmɑˌliːkenːeˣˌjuo̯pumus
ilmankosteus	ˈilmɑnˌkosteus
ilmanpuhallin	ˈilmɑnˌpuhɑlːin
ilmapatsas	ˈilmɑˌpɑtsɑs
ilmarengas	ˈilmɑˌreŋːɑs
ilmastodenialisti	ˈilmɑstoˌdeniɑlisti
ilmastokausi	ˈilmɑstoˌkɑu̯si
ilmasulku	ˈilmɑˌsulku
ilmatorjunta-ase	ˈilmɑˌtorjuntɑˌ(ʔ)ɑseˣ
ilmatähystys	ˈilmɑˌtæhystys
ilmavoitto	ˈilmɑˌʋoi̯tːo
ilmeneminen	ˈilmeneminen
ilmi	ˈilmi
ilmisota	ˈilmiˌsotɑ
ilmoittaa	ˈilmoi̯tːɑːˣ
ilmoituslehti	ˈilmoi̯tusˌlehti
ilmoitusvelvollinen	ˈilmoi̯tusˌʋelʋolːinen
ilokaasu	ˈiloˌkɑːsu
ilonaihe	ˈilonˌɑi̯heˣ
ilouutinen	ˈiloˌuːtinen
iltahuuto	ˈiltɑˌhuːto
iltakaksitoista	ˈiltɑˌkɑksiˌtoi̯stɑ
iltakävely	ˈiltɑˌkæʋely
iltamyöhäinen	ˈiltɑˌmyø̯hæi̯nen
iltapimeä	ˈiltɑˌpimeæ
iltapäiväruuhka	ˈiltɑˌpæi̯ʋæˌruːhkɑ
iltatori	ˈiltɑˌtori
iltavoimistelu	ˈiltɑˌʋoi̯mistelu
imaami	ˈimɑːmi
imarrella	ˈimɑrːelːɑˣ
imelyys	ˈimelyːs
imeskely	ˈimeskely
imeytyminen	ˈimey̯tyminen
immanentti	ˈimːɑnentːi
immunokemia	ˈimːunoˌkemiɑ
immuunivälitteinen	ˈimːuːniˌʋælitːei̯nen
impivaaralaisuus	ˈimpiˌʋɑːrɑlɑi̯suːs
impregnointi	ˈimpreɡnoi̯nti
imputaatio	ˈimputɑːtio
imukeräily	ˈimuˌkeræi̯ly
imupumppu	ˈimuˌpumpːu
imusuonipunos	ˈimuˌsuo̯niˌpunos
inarinsaamelainen	ˈinɑrinˌsɑːmelɑi̯nen
indifferenssi	ˈindifːerensːi
indispositiivinen	ˈindispositiːʋinen
induktiovirta	ˈinduktioˌʋirtɑ
inessä	ˈinesːæ
infinitiivi	ˈinfinitiːʋi
info	ˈinf(ː)o
informaatiopalvelu	ˈinformɑːtioˌpɑlʋelu
informaatiovaikuttaminen	ˈinformɑːtioˌʋɑi̯kutːɑminen
infra	ˈinfrɑ
ingressi	ˈiŋresːi
inhiminen	ˈinhiminen
injektoiminen	ˈinjektoi̯minen
inkerinsuomalainen	ˈiŋkerinˌsuo̯mɑlɑi̯nen
inkongruenssi	ˈiŋkoŋruensːi
inkvisitio	ˈin.kʋisitio
innostuneesti	ˈinːostuneːstiˣ
innovointi	ˈinːoʋoi̯nti
insinööriupseeri	ˈinsinøːriˌupseːri
institutionaalistuminen	ˈinstitutionɑːlistuminen
instrumentaaliryhmä	ˈinstrumentɑːliˌryhmæ
insuliiniruiske	ˈinsuliːniˌrui̯skeˣ
integriteetti	ˈinteɡriteːtːi
intelligentti	ˈintelːiɡentːi
interferoni	ˈinterferoni
internetpuhelin	ˈinternetˌpuhelin
intersektionaalinen	ˈinterˌsektionɑːlinen
intiaanisota	ˈintiɑːniˌsotɑ
intohimottomuus	ˈintoˌhimotːomuːs
intressiryhmä	ˈintresːiˌryhmæ
inttäminen	ˈintːæminen
invalidihissi	ˈinʋɑlidiˌhisːi
inventio	ˈinʋentio
investointitalletus	ˈinʋestoi̯ntiˌtɑlːetus
ionipumppu	ˈioniˌpumpːu
irkata	ˈirkɑtɑˣ
irrallisuus	ˈirːɑlːisuːs
irrokepaperi	ˈirːokeˣˌpɑperi
irsokki	ˈirsokːi
irti	ˈirtiˣ
irto-	ˈirto-
irtokaulus	ˈirtoˌkɑu̯lus
irtoliite	ˈirtoˌliːteˣ
irtonaisuus	ˈirtonɑi̯suːs
irtoripset	ˈirtoˌripset
irtotukka	ˈirtoˌtukːɑ
irvileuka	ˈirʋiˌleu̯kɑ
isentalpinen	ˈisentɑlpinen
iskemä	ˈiskemæ
iskullinen	ˈiskulːinen
iskurityöläinen	ˈiskuriˌtyø̯læi̯nen
iskuvasara	ˈiskuˌʋɑsɑrɑ
isoaivokuori	ˈisoˌɑi̯ʋoˌkuo̯ri
isoinen	ˈisoi̯nen
isokyröläinen	ˈisoˌkyrølæi̯nen
isomeeri	ˈisomeːri
isontaa	ˈisontɑːˣ
isorytminen	ˈisoˌrytminen
isosuinen	ˈisoˌsui̯nen
isotooppikello	ˈisotoːpːiˌkelːo
isovarvas	ˈisoˌʋɑrʋɑs
isoääninen	ˈisoˌæːninen
istua	ˈistuɑˣ
istuinkartta	ˈistui̯nˌkɑrtːɑ
istukallinen	ˈistukɑlːinen
istumaannousu	ˈistumɑːnˌnou̯su
istuntosali	ˈistuntoˌsɑli
istutusmetsä	ˈistutusˌmetsæ
istuviltaan	ˈistuʋiltɑːn
isänisä	ˈisænˌisæ
isännöitsijäntodistus	ˈisænːøi̯tsijænˌtodistus
isäntärenki	ˈisæntæˌreŋki
italialaisnainen	ˈitɑliɑlɑi̯sˌnɑi̯nen
itiö	ˈitiø
itkeä	ˈitkeæˣ
itkupilli	ˈitkuˌpilːi
itsearvostus	ˈitseˌɑrʋostus
itsehavainnointi	ˈitseˌhɑʋɑi̯nːoi̯nti
itseinho	ˈitseˌinho
itsekehu	ˈitseˌkehu
itsekorostus	ˈitseˌkorostus
itseliimautuva	ˈitseˌliːmɑu̯tuʋɑ
itsemurhahyökkäys	ˈitseˌmurhɑˌhyø̯kːæys
itsemurhayritys	ˈitseˌmurhɑˌyritys
itsenäistäminen	ˈitsenæi̯stæminen
itseohjautuva	ˈitseˌohjɑu̯tuʋɑ
itsepalveluhuoltamo	ˈitseˌpɑlʋeluˌhuo̯ltɑmo
itsepintaisesti	ˈitseˌpintɑi̯sestiˣ
itserakas	ˈitseˌrɑkɑs
itsesensuuri	ˈitseˌsensuːri
itsesuojelu	ˈitseˌsuo̯jelu
itsesääntely	ˈitseˌsæːntely
itsetiedoton	ˈitseˌtie̯doton
itsetuhokäyttäytyminen	ˈitseˌtuhoˌkæy̯tːæy̯tyminen
itsetärkeys	ˈitseˌtærkeys
itsevarma	ˈitseˌʋɑrmɑ
itusilmu	ˈituˌsilmu
itämaa	ˈitæˌmɑː
itäpuolinen	ˈitæˌpuo̯linen
itätaivas	ˈitæˌtɑi̯ʋɑs
ivaaminen	ˈiʋɑːminen
iäisyysajatus	ˈiæi̯syːsˌɑjɑtus
iätön	ˈiætøn
jahkailla	ˈjɑhkɑi̯lːɑˣ
jakaa oman käden oikeutta	ˈjɑkɑːˣ ˈomɑn ˈkæden ˈoi̯keutːɑ
jakelin	ˈjɑkelin
jakelupaikka	ˈjɑkeluˌpɑi̯kːɑ
jako	ˈjɑko
jakokunta	ˈjɑkoˌkuntɑ
jakosuodin	ˈjɑkoˌsuo̯din
jaksamaton	ˈjɑksɑmɑton
jaksoluku	ˈjɑksoˌluku
jalansija	ˈjɑlɑnˌsijɑ
jalka	ˈjɑlkɑ
jalkakylpy	ˈjɑlkɑˌkylpy
jalkapallofani	ˈjɑlkɑˌpɑlːoˌfɑni
jalkapumppu	ˈjɑlkɑˌpumpːu
jalkaterä	ˈjɑlkɑˌteræ
jalkavaivainen	ˈjɑlkɑˌʋɑi̯ʋɑi̯nen
jalkine	ˈjɑlkineˣ
jallittaminen	ˈjɑlːitːɑminen
jaloittelu	ˈjɑloi̯tːelu
jaloluonteinen	ˈjɑloˌluo̯ntei̯nen
jalopeura	ˈjɑloˌpeu̯rɑ
jaloste	ˈjɑlosteˣ
jalosydämisyys	ˈjɑloˌsydæm(ː)isyːs
jama	ˈjɑmɑ
jankkaus	ˈjɑŋkːɑus
janoinen	ˈjɑnoi̯nen
jaokkeinen	ˈjɑokːei̯nen
japanilaismies	ˈjɑpɑnilɑi̯sˌmie̯s
japsi	ˈjɑpsi
jarrupoljin	ˈjɑrːuˌpoljin
jarrutuspolitiikka	ˈjɑrːutusˌpolitiːkːɑ
jatkaa	ˈjɑtkɑːˣ
jatkojalostaa	ˈjɑtkoˌjɑlostɑːˣ
jatkolevy	ˈjɑtkoˌleʋy
jatkua	ˈjɑtkuɑˣ
jatsari	ˈjɑtsɑri
jauhattaminen	ˈjɑu̯hɑtːɑminen
jauhettu	ˈjɑu̯hetːu
jauhonpöly	ˈjɑu̯honˌpøly
jauhovelli	ˈjɑu̯hoˌʋelːi
jeesustelija	ˈjeːsustelijɑ
jenginuori	ˈjeŋːiˌnuo̯ri
jenkkifutis	ˈjeŋkːiˌfutis
jenni	ˈjenːi
jersey	ˈdʒøːzi
jesuiittaveljestö	ˈjesui̯ːtːɑˌʋeljestø
jii	ˈjiː
jobinposti	ˈjobinˌposti
jodlaus	ˈjodlɑus
joglisiinihappo	ˈjoɡlisiːniˌhɑpːo
johdannaismarkkinat	ˈjohdɑnːɑi̯sˌmɑrkːinɑt
johdatteleva	ˈjohdɑtːeleʋɑ
johdonsuojakatkaisija	ˈjohdonˌsuo̯jɑˌkɑtkɑi̯sijɑ
johtajantauti	ˈjohtɑjɑnˌtɑu̯ti
johtamissopimus	ˈjohtɑmisˌsopimus
johtohenkilö	ˈjohtoˌheŋkilø
johtopääte	ˈjohtoˌpæːteˣ
johtoteema	ˈjohtoˌteːmɑ
jojo	ˈjojo
jokakesäinen	ˈjokɑˌkesæi̯nen
jokarmihappo	ˈjokɑrmiˌhɑpːo
jokeri	ˈjokeri
jokikala	ˈjokiˌkɑlɑ
jokin	ˈjokin
jokisuu	ˈjokiˌsuː
jokseenkin	ˈjokseːŋkin
jollei	ˈjolːei̯
jommoinen	ˈjomːoi̯nen
jonottaa	ˈjonotːɑːˣ
joogi	ˈjoːɡi
joraus	ˈjorɑus
jorpakko	ˈjorpɑkːo
jossitella	ˈjosːitelːɑˣ
jotroksihappo	ˈjotroksiˌhɑpːo
jouhevuus	ˈjou̯heʋuːs
jouhivihvilä	ˈjou̯hiˌʋihʋilæ
joukkoeroaminen	ˈjou̯kːoˌeroɑminen
joukkojakelu	ˈjou̯kːoˌjɑkelu
joukkoliikenneväline	ˈjou̯kːoˌliːkenːeˣˌʋælineˣ
joukkosielu	ˈjou̯kːoˌsie̯lu
joukkotoiminta	ˈjou̯kːoˌtoi̯mintɑ
joukkoyksikkö	ˈjou̯kːoˌyksikːø
joukkuemäkihyppy	ˈjou̯kːueˣˌmækiˌhypːy
jouluevankeliumi	ˈjou̯luˌeʋɑŋkeliu̯mi
joulukalkkuna	ˈjou̯luˌkɑlkːunɑ
joulukynttilä	ˈjou̯luˌkyntːilæ
joulumielinen	ˈjou̯luˌmie̯linen
jouluostos	ˈjou̯luˌostos
jouluruno	ˈjou̯luˌruno
jouluvalmistelut	ˈjou̯luˌʋɑlmistelut
jousihaka	ˈjou̯siˌhɑkɑ
jousisto	ˈjou̯sisto
joustava	ˈjou̯stɑʋɑ
joustolanka	ˈjou̯stoˌlɑŋkɑ
jouten	ˈjou̯ten
joutomies	ˈjou̯toˌmie̯s
joutsi	ˈjou̯tsi
juhannus	ˈjuhɑnːus
juhlahumu	ˈjuhlɑˌhumu
juhlakunto	ˈjuhlɑˌkunto
juhlanäytäntö	ˈjuhlɑˌnæy̯tæntø
juhlatilaisuus	ˈjuhlɑˌtilɑi̯suːs
juhlavieras	ˈjuhlɑˌʋie̯rɑs
juju	ˈjuju
julkaisu	ˈjulkɑi̯su
julkaisutieto	ˈjulkɑi̯suˌtie̯to
julkiset	ˈjulkiset
julkisuuskuva	ˈjulkisuːsˌkuʋɑ
jumbokoko	ˈjumboˌkoko
juna-asema	ˈjunɑˌ(ʔ)ɑsemɑ
junktuuri	ˈjuŋktuːri
juoda	ˈjuo̯dɑˣ
juoksukalja	ˈjuo̯ksuˌkɑljɑ
juoksuttaminen	ˈjuo̯ksutːɑminen
juomakuppi	ˈjuo̯mɑˌkupːi
juoni	ˈjuo̯ni
juoppokööri	ˈjuo̯pːoˌkøːri
juote	ˈjuo̯teˣ
juovahyeena	ˈjuo̯ʋɑˌhyeːnɑ
jurosti	ˈjurostiˣ
juudaksenkorva	ˈjuːdɑksenˌkorʋɑ
juures	ˈjuːres
juurihuntu	ˈjuːriˌhuntu
juurileipä	ˈjuːriˌlei̯pæ
juuripaikka	ˈjuːriˌpɑi̯kːɑ
juurruttaa	ˈjuːrːutːɑːˣ
juustokastike	ˈjuːstoˌkɑstikeˣ
juustoteollisuus	ˈjuːstoˌteolːisuːs
jykevä	ˈjykeʋæ
jymy-yllätys	ˈjymyˌ(ʔ)ylːætys
jymäys	ˈjymæys
jyrketä	ˈjyrketæˣ
jyrkkärinteinen	ˈjyrkːæˌrintei̯nen
jyrsiä	ˈjyrsiæˣ
jyskyttää	ˈjyskytːæːˣ
jytkyttäminen	ˈjytkytːæminen
jyvänen	ˈjyʋænen
jäkittää	ˈjækitːæːˣ
jäljestää	ˈjæljestæːˣ
jälki	ˈjælki
jälkimarkkinat	ˈjælkiˌmɑrkːinɑt
jälkiselostus	ˈjælkiˌselostus
jälkivarmistus	ˈjælkiˌʋɑrmistus
jälleenrakentaminen	ˈjælːeːnˌrɑkentɑminen
jämtti	ˈjæmtːi
jänkkä	ˈjæŋkːæ
jännitepiikki	ˈjænːiteˣˌpiːkːi
jännittävä	ˈjænːitːæʋæ
jännäri	ˈjænːæri
jäntevöityä	ˈjænteʋøi̯tyæˣ
järeästi	ˈjæreæstiˣ
järjestelmä	ˈjærjestelmæ
järjestelmäveikkaus	ˈjærjestelmæˌʋei̯kːɑus
järjestelyvara	ˈjærjestelyˌʋɑrɑ
järjestynyt	ˈjærjestynyt
järjestysteoria	ˈjærjestysˌteoriɑ
järjestää	ˈjærjestæːˣ
järjestöneuvos	ˈjærjestøˌneu̯ʋos
järkevyys	ˈjærkeʋyːs
järkiperäisesti	ˈjærkiˌperæi̯sestiˣ
järkkäri	ˈjærkːæri
järkähtämätön	ˈjærkæhtæmætøn
järvenpinta	ˈjærʋenˌpintɑ
järviristeily	ˈjærʋiˌristei̯ly
jäsenteleminen	ˈjæsenteleminen
jäte	ˈjæteˣ
jätekatos	ˈjæteˣˌkɑtos
jätemaksu	ˈjæteˣˌmɑksu
jätevarasto	ˈjæteˣˌʋɑrɑsto
jätkänkynttilä	ˈjætkænˌkyntːilæ
jättiläinen	ˈjætːilæi̯nen
jättää	ˈjætːæːˣ
jäykentää	ˈjæy̯kentæːˣ
jäykkäluonteinen	ˈjæy̯kːæˌluo̯ntei̯nen
jäädyke	ˈjæːdykeˣ
jääeste	ˈjæːˌesteˣ
jäähile	ˈjæːˌhileˣ
jääkalikka	ˈjæːˌkɑlikːɑ
jääkiekkoilu	ˈjæːˌkie̯kːoi̯lu
jäälauta	ˈjæːˌlɑu̯tɑ
jäämurtaja	ˈjæːˌmurtɑjɑ
jäännöslopuke	ˈjæːnːøsˌlopukeˣ
jääpalapihdit	ˈjæːˌpɑlɑˌpihdit
jääpyynti	ˈjæːˌpyːnti
jääsalaatti	ˈjæːˌsɑlɑːtːi
jäätanssi	ˈjæːˌtɑnsːi
jäätelötötterö	ˈjæːteløˌtøtːerø
jääurheilu	ˈjæːˌurhei̯lu
jäävuori	ˈjæːˌʋuo̯ri
jötikkä	ˈjøtikːæ
kaaderipuolue	ˈkɑːderiˌpuo̯lueˣ
kaakeli	ˈkɑːkeli
kaakki	ˈkɑːkːi
kaalamo	ˈkɑːlɑmo
kaalipieru	ˈkɑːliˌpie̯ru
kaanaankieli	ˈkɑːnɑːnˌkie̯li
kaapelikela	ˈkɑːpeliˌkelɑ
kaapelivälitteinen	ˈkɑːpeliʋˌælitːei̯nen
kaappailu	ˈkɑːpːɑi̯lu
kaappinatsi	ˈkɑːpːiˌnɑtsi
kaareutua	ˈkɑːreu̯tuɑˣ
kaarikatto	ˈkɑːriˌkɑtːo
kaarisekunti	ˈkɑːriˌsekunt(ː)i
kaarna	ˈkɑːrnɑ
kaartaminen	ˈkɑːrtɑminen
kaasu	ˈkɑːsu
kaasuhella	ˈkɑːsuˌhelːɑ
kaasukenttä	ˈkɑːsuˌkentːæ
kaasulämmitin	ˈkɑːsuˌlæmːitin
kaasunpoisto	ˈkɑːsunˌpoi̯sto
kaasusumu	ˈkɑːsuˌsumu
kaasutinmoottori	ˈkɑːsutinˌmoːtːori
kaasuvalo	ˈkɑːsuˌʋɑlo
kaateleminen	ˈkɑːteleminen
kaatoryhmä	ˈkɑːtoˌryhmæ
kaavamaisesti	ˈkɑːʋɑmɑi̯sestiˣ
kaavata	ˈkɑːʋɑtɑˣ
kaavinta	ˈkɑːʋintɑ
kaavoitusmenettely	ˈkɑːʋoi̯tusˌmenetːely
kabotaasi	ˈkɑbotɑːsi
kademielisyys	ˈkɑdeˣˌmie̯lisyːs
kadottaminen	ˈkɑdotːɑminen
kadunvarsi	ˈkɑdunˌʋɑrsi
kahakoida	ˈkɑhɑkoi̯dɑˣ
kahdeksankymmentä	ˈkɑhdeksɑnˌkymːentæ
kahdeksasti	ˈkɑhdeksɑstiˣ
kahdes	ˈkɑhdes
kahlaus	ˈkɑhlɑus
kahluuhousut	ˈkɑhluːˌhou̯sut
kahtaissara	ˈkɑhtɑi̯sˌsɑrɑ
kahu	ˈkɑhu
kahviaamiainen	ˈkɑhʋiˌɑːmiɑi̯nen
kahvikannu	ˈkɑhʋiˌkɑnːu
kahvikuppi	ˈkɑhʋiˌkupːi
kahvinpaahdin	ˈkɑhʋinˌpɑːhdin
kahvipöytä	ˈkɑhʋiˌpøy̯tæ
kahviviljelmä	ˈkɑhʋiˌʋiljelmæ
kaihilasit	ˈkɑi̯hiˌlɑsit
kaikaa	ˈkɑi̯kɑːˣ
kaikenmoinen	ˈkɑi̯kenmoi̯nen
kaikitenkin	ˈkɑi̯kiteŋkin
kaikkineen	ˈkɑi̯kːineːn
kaikukuvaus	ˈkɑi̯kuˌkuʋɑus
kailotus	ˈkɑi̯lotus
kaino	ˈkɑi̯no
kaipaaminen	ˈkɑi̯pɑːminen
kairapalmu	ˈkɑi̯rɑˌpɑlmu
kaista	ˈkɑi̯stɑ
kaistaviiva	ˈkɑi̯stɑˌʋiːʋɑ
kaitanokkalokki	ˈkɑi̯tɑˌnokːɑˌlokːi
kaiuttaa	ˈkɑi̯utːɑːˣ
kaivausdokumentointi	ˈkɑi̯ʋɑusˌdokumentoi̯nti
kaiverruskoristelu	ˈkɑi̯ʋerːusˌkoristelu
kaivoskaasu	ˈkɑi̯ʋosˌkɑːsu
kaivosyhtiö	ˈkɑi̯ʋosˌyhtiø
kajahdella	ˈkɑjɑhdelːɑˣ
kajakoida	ˈkɑjɑkoi̯dɑˣ
kajentaa	ˈkɑjentɑːˣ
kaki	ˈkɑki
kakki	ˈkɑkːi
kakkosketju	ˈkɑkːosˌketju
kakkuotin	ˈkɑkːuˌotin
kaksihaaraviuhko	ˈkɑksiˌhɑːrɑˌʋiu̯hko
kaksikielinen	ˈkɑksiˌkie̯linen
kaksikäsitteinen	ˈkɑksiˌkæsitːei̯nen
kaksiminuuttinen	ˈkɑksiˌminuːtːinen
kaksinapaisesti	ˈkɑksiˌnɑpɑi̯sestiˣ
kaksinpuhelu	ˈkɑksinˌpuhelu
kaksipuoluemaa	ˈkɑksiˌpuo̯lueˣˌmɑː
kaksisukuinen	ˈkɑksiˌsukui̯nen
kaksitoiminen	ˈkɑksiˌtoi̯minen
kaksiulotteisesti	ˈkɑksiˌulotːei̯sestiˣ
kaksiymmärteinen	ˈkɑksiˌymːærtei̯nen
kaksoishyppy	ˈkɑksoi̯sˌhypːy
kaksoiskovera	ˈkɑksoi̯sˌkoʋerɑ
kaksoisnappi	ˈkɑksoi̯sˌnɑpːi
kaksoisrattaat	ˈkɑksoi̯sˌrɑtːɑːt
kaksoisvee	ˈkɑksoi̯sˌʋeː
kaksoslapsi	ˈkɑksosˌlɑpsi
kaktus	ˈkɑktus
kalafilee	ˈkɑlɑˌfileː
kalainen	ˈkɑlɑi̯nen
kalakauppa	ˈkɑlɑˌkɑu̯pːɑ
kalalammikko	ˈkɑlɑˌlɑmːikːo
kalamureke	ˈkɑlɑˌmurekeˣ
kalanmäti	ˈkɑlɑnˌmæti
kalansavustamo	ˈkɑlɑnˌsɑʋustɑmo
kalapatsas	ˈkɑlɑˌpɑtsɑs
kalasaalis	ˈkɑlɑˌsɑːlis
kalastavuus	ˈkɑlɑstɑʋuːs
kalastusmatkailu	ˈkɑlɑstusˌmɑtkɑi̯lu
kalasumppu	ˈkɑlɑˌsumpːu
kalatauti	ˈkɑlɑˌtɑu̯ti
kalavalmiste	ˈkɑlɑˌʋɑlmisteˣ
kalenterinimi	ˈkɑlenteriˌnimi
kalin	ˈkɑlin
kaliumoksidi	ˈkɑliumˌoksidi
kaljavelli	ˈkɑljɑˌʋelːi
kalkatus	ˈkɑlkɑtus
kalkkaro	ˈkɑlkːɑro
kalkkilaiva	ˈkɑlkːiˌlɑi̯ʋɑ
kalkkis	ˈkɑlkːis
kalkkunanliha	ˈkɑlkːunɑnˌlihɑ
kallas	ˈkɑlːɑs
kalliisti	ˈkɑlːiːstiˣ
kalliokasvi	ˈkɑlːioˌkɑsʋi
kallioluola	ˈkɑlːioˌluo̯lɑ
kallionlohkare	ˈkɑlːionˌlohkɑreˣ
kallioranta	ˈkɑlːioˌrɑntɑ
kallis	ˈkɑlːis
kallistusmittari	ˈkɑlːistusˌmitːɑri
kallovamma	ˈkɑlːoˌʋɑmːɑ
kalmo	ˈkɑlmo
kalossi	ˈkɑlosːi
kalpeakasvoinen	ˈkɑlpeɑˌkɑsʋoi̯nen
kalseasti	ˈkɑlseɑstiˣ
kalsu	ˈkɑlsu
kalttaaminen	ˈkɑltːɑːminen
kalusteteollisuus	ˈkɑlusteˣˌteolːisuːs
kaluunanauha	ˈkɑluːnɑˌnɑu̯hɑ
kalveta	ˈkɑlʋetɑˣ
kalvopumppu	ˈkɑlʋoˌpumpːu
kamarikuoro	ˈkɑmɑriˌkuo̯ro
kamariyhtye	ˈkɑmɑriˌyhtyeˣ
kamelinkarvaulsteri	ˈkɑmelinˌkɑrʋɑˌulsteri
kameratarkkailu	ˈkɑmerɑˌtɑrkːɑi̯lu
kammiovesi	ˈkɑmːioˌʋesi
kampaajamestari	ˈkɑmpɑːjɑˌmestɑri
kampanjointi	ˈkɑmp(ː)ɑnjoi̯nti
kampeaminen	ˈkɑmpeɑminen
kamppailu-urheilija	ˈkɑmpːɑi̯luˌ(ʔ)urhei̯lijɑ
kampusalue	ˈkɑmpusˌɑlueˣ
kanadanmajava	ˈkɑnɑdɑnˌmɑjɑʋɑ
kanakolera	ˈkɑnɑˌkolerɑ
kanamaisesti	ˈkɑnɑmɑi̯sestiˣ
kananpaisti	ˈkɑnɑnˌpɑi̯sti
kanariankeltainen	ˈkɑnɑriɑnˌkeltɑi̯nen
kanasta	ˈkɑnɑstɑ
kanavanippu	ˈkɑnɑʋɑˌnipːu
kanavaverkko	ˈkɑnɑʋɑˌʋerkːo
kanelikierre	ˈkɑneliˌkie̯rːeˣ
kanervakäärme	ˈkɑnerʋɑˌkæːrmeˣ
kangashumus	ˈkɑŋːɑsˌhumus
kangasliike	ˈkɑŋːɑsˌliːkeˣ
kangaspäällys	ˈkɑŋːɑsˌpæːlːys
kangasteollisuus	ˈkɑŋːɑsˌteolːisuːs
kangeta	ˈkɑŋːetɑˣ
kanittaminen	ˈkɑnitːɑminen
kankea	ˈkɑŋkeɑ
kanna	ˈkɑnːɑ
kannanmääritys	ˈkɑnːɑnˌmæːritys
kannattaa	ˈkɑnːɑtːɑːˣ
kannatusmaksu	ˈkɑnːɑtusˌmɑksu
kanneltaja	ˈkɑnːeltɑjɑ
kannonnosto	ˈkɑnːonˌnosto
kannuslainen	ˈkɑnːuslɑi̯nen
kannustinkarttuma	ˈkɑnːustinˌkɑrtːumɑ
kansainvälinen	ˈkɑnsɑi̯nˌʋælinen
kansalainen	ˈkɑnsɑlɑi̯nen
kansalaiskunto	ˈkɑnsɑlɑi̯sˌkunto
kansalaispiiri	ˈkɑnsɑlɑi̯sˌpiːri
kansalaisuuslaki	ˈkɑnsɑlɑi̯suːsˌlɑki
kansallisuuskysymys	ˈkɑnsɑlːisuːsˌkysymys
kansaneläkejärjestelmä	ˈkɑnsɑnˌelækeˣˌjærjestelmæ
kansanhuvi	ˈkɑnsɑnˌhuʋi
kansankiihotus	ˈkɑnsɑnˌkiːhotus
kansanlaulu	ˈkɑnsɑnˌlɑu̯lu
kansanmurre	ˈkɑnsɑnˌmurːeˣ
kansanomaisuus	ˈkɑnsɑnˌomɑi̯suːs
kansanperinteentutkimus	ˈkɑnsɑnˌperinteːnˌtutkimus
kansanryhmä	ˈkɑnsɑnˌryhmæ
kansansävelmä	ˈkɑnsɑnˌsæʋelmæ
kansantaloustieteilijä	ˈkɑnsɑnˌtɑlousˌtie̯tei̯lijæ
kansantuote	ˈkɑnsɑnˌtuo̯teˣ
kansanvaltaisuus	ˈkɑnsɑnˌʋɑltɑi̯suːs
kansialanimeke	ˈkɑnsiˌɑlɑˌnimekeˣ
kansipaikka	ˈkɑnsiˌpɑi̯kːɑ
kansliahenkilökunta	ˈkɑnsliɑˌheŋkiløˌkuntɑ
kanssaeläjä	ˈkɑnsːɑˌelæjæ
kantaitiö	ˈkɑntɑˌitiø
kantakirjalehmä	ˈkɑntɑˌkirjɑˌlehmæ
kantamaton	ˈkɑntɑmɑton
kantapohja	ˈkɑntɑˌpohjɑ
kantasuomalainen	ˈkɑntɑˌsuo̯mɑlɑi̯nen
kantaäiti	ˈkɑntɑˌæi̯ti
kantio	ˈkɑntio
kantokahva	ˈkɑntoˌkɑhʋɑ
kantokykyluokka	ˈkɑntoˌkykyˌluo̯kːɑ
kantopinta	ˈkɑntoˌpintɑ
kantosieni	ˈkɑntoˌsie̯ni
kanttaus	ˈkɑntːɑus
kaoottisesti	ˈkɑoːtːisestiˣ
kapaloiminen	ˈkɑpɑloi̯minen
kapeaharteinen	ˈkɑpeɑˌhɑrtei̯nen
kapearunkoinen	ˈkɑpeɑˌruŋkoi̯nen
kapillaarinen	ˈkɑpilːɑːrinen
kapinallisliike	ˈkɑpinɑlːisˌliːkeˣ
kapiolakana	ˈkɑpioˌlɑkɑnɑ
kapoinen	ˈkɑpoi̯nen
kappalekauppa	ˈkɑpːɑleˣˌkɑu̯pːɑ
kappeliseurakunta	ˈkɑpːeliˌseu̯rɑˌkuntɑ
kapsahdus	ˈkɑpsɑhdus
kapsäkki	ˈkɑpsækːi
kaput	ˈkɑput
karahtaminen	ˈkɑrɑhtɑminen
karakteristinen	ˈkɑrɑkteristinen
karamelliväri	ˈkɑrɑmelːiˌʋæri
karboksyyliryhmä	ˈkɑrboksyːliˌryhmæ
kardinaalikollegio	ˈkɑrdinɑːliˌkolːeɡio
karenssi	ˈkɑrensːi
karhi	ˈkɑrhi
karhukainen	ˈkɑrhukɑi̯nen
karhunkaataja	ˈkɑrhunˌkɑːtɑjɑ
karhunpesä	ˈkɑrhunˌpesæ
kari	ˈkɑri
karikkoranta	ˈkɑrikːoˌrɑntɑ
karismaatikko	ˈkɑrismɑːtikːo
karistesieni	ˈkɑristeˣˌsie̯ni
karitsoittaa	ˈkɑritsoi̯tːɑːˣ
karjahdus	ˈkɑrjɑhdus
karjanhoitaja	ˈkɑrjɑnˌhoi̯tɑjɑ
karjanpito	ˈkɑrjɑnˌpito
karjataloustekniikka	ˈkɑrjɑˌtɑlousˌtekniːkːɑ
karkaaminen	ˈkɑrkɑːminen
karkaussekunti	ˈkɑrkɑusˌsekunti
karkeapuheinen	ˈkɑrkeɑˌpuhei̯nen
karkeishionta	ˈkɑrkei̯sˌhiontɑ
karkkikauppa	ˈkɑrkːiˌkɑu̯pːɑ
karkotusmääräys	ˈkɑrkotusˌmæːræys
karkuteillä	ˈkɑrkuˌtei̯lːæ
karmeus	ˈkɑrmeus
karnevaalisamba	ˈkɑrneʋɑːliˌsɑmbɑ
karpalo	ˈkɑrpɑlo
karppaus	ˈkɑrpːɑus
karrikatyyri	ˈkɑrːikɑtyːri
karsikkopuu	ˈkɑrsikːoˌpuː
karsinoitua	ˈkɑrsinoi̯tuɑˣ
karstaaminen	ˈkɑrstɑːminen
kartanonrouva	ˈkɑrtɑnonˌrou̯ʋɑ
karting	ˈkɑrtiŋː
kartoittaminen	ˈkɑrtoi̯tːɑminen
karttakokoelma	ˈkɑrtːɑˌkokoelmɑ
karttapalvelu	ˈkɑrtːɑˌpɑlʋelu
karttu	ˈkɑrtːu
kartusiaanimunkki	ˈkɑrtusiɑːniˌmuŋkːi
karva	ˈkɑrʋɑ
karvakaulus	ˈkɑrʋɑˌkɑu̯lus
karvalankamatto	ˈkɑrʋɑˌlɑŋkɑˌmɑtːo
karvanluonti	ˈkɑrʋɑnˌluo̯nti
karvarintainen	ˈkɑrʋɑˌrintɑi̯nen
karvasputki	ˈkɑrʋɑsˌputki
karvoa	ˈkɑrʋoɑˣ
kasakkajoukko	ˈkɑsɑkːɑˌjou̯kːo
kasarmialue	ˈkɑsɑrmiˌɑlueˣ
kasetointi	ˈkɑsetoi̯nti
kasiainen	ˈkɑsiɑi̯nen
kaskenpolttaja	ˈkɑskenˌpoltːɑjɑ
kaskovakuutus	ˈkɑskoˌʋɑkuːtus
kassahallinto	ˈkɑsːɑˌhɑlːinto
kassalipas	ˈkɑsːɑˌlipɑs
kassara	ˈkɑsːɑrɑ
kasteinen	ˈkɑstei̯nen
kasteluauto	ˈkɑsteluˌɑu̯to
kastepisara	ˈkɑsteˣˌpisɑrɑ
kastijako	ˈkɑstiˌjɑko
kastliina	ˈkɑstˌliːnɑ
kasuuni	ˈkɑsuːni
kasvattivanhemmat	ˈkɑsʋɑtːiˌʋɑnhemːɑt
kasvatusjärjestelmä	ˈkɑsʋɑtusˌjærjestelmæ
kasvatusopillinen	ˈkɑsʋɑtusˌopilːinen
kasvatustoimi	ˈkɑsʋɑtusˌtoi̯mi
kasviekologi	ˈkɑsʋiˌekoloɡi
kasvihuonepäästö	ˈkɑsʋiˌhuo̯neˣˌpæːstø
kasviliima	ˈkɑsʋiˌliːmɑ
kasvineste	ˈkɑsʋiˌnesteˣ
kasvintarkastus	ˈkɑsʋinˌtɑrkɑstus
kasvipaleontologia	ˈkɑsʋiˌpɑleontoˌloɡiɑ
kasvirasva	ˈkɑsʋiˌrɑsʋɑ
kasvismuhennos	ˈkɑsʋisˌmuhenːos
kasvisruokavalio	ˈkɑsʋisˌruo̯kɑˌʋɑlio
kasvitieteilijä	ˈkɑsʋiˌtie̯tei̯lijæ
kasviyhdyskunta	ˈkɑsʋiˌyhdysˌkuntɑ
kasvokuva	ˈkɑsʋoˌkuʋɑ
kasvopyyhe	ˈkɑsʋoˌpyːheˣ
kasvualusta	ˈkɑsʋuˌɑlustɑ
kasvulehti	ˈkɑsʋuˌlehti
kasvupaikkatekijä	ˈkɑsʋuˌpɑi̯kːɑˌtekijæ
kasvutiheys	ˈkɑsʋuˌtiheys
katajanhavu	ˈkɑtɑjɑnˌhɑʋu
katalasti	ˈkɑtɑlɑstiˣ
katapultti-istuin	ˈkɑtɑpultːiˌ(ʔ)istui̯n
katastrofielokuva	ˈkɑtɑstrofiˌeloˌkuʋɑ
katederi	ˈkɑtederi
kateisiin	ˈkɑtei̯siːn
katenointi	ˈkɑtenoi̯nti
katetuottolaskenta	ˈkɑteˣˌtuo̯tːoˌlɑskentɑ
katkaisija	ˈkɑtkɑi̯sijɑ
katkaisupeli	ˈkɑtkɑi̯suˌpeli
katkeileminen	ˈkɑtkei̯leminen
katkero	ˈkɑtkero
katkola	ˈkɑtkolɑ
katoalue	ˈkɑtoˌɑlueˣ
katodisädeputki	ˈkɑtodiˌsædeˣˌputki
katosvuode	ˈkɑtosˌʋuo̯deˣ
katsanto	ˈkɑtsɑnto
katsausartikkeli	ˈkɑtsɑusˌɑrtikːeli
katselmustoimitus	ˈkɑtselmusˌtoi̯mitus
katsoja	ˈkɑtsojɑ
kattaja	ˈkɑtːɑjɑ
kattilalaitteisto	ˈkɑtːilɑˌlɑi̯tːei̯sto
kattolamppu	ˈkɑtːoˌlɑmpːu
kattopaanu	ˈkɑtːoˌpɑːnu
kattoulkonema	ˈkɑtːoˌulkonemɑ
katuhaastattelu	ˈkɑtuˌhɑːstɑtːelu
katukivetys	ˈkɑtuˌkiʋetys
katumaasturi	ˈkɑtuˌmɑːsturi
katuoja	ˈkɑtuˌojɑ
katusulku	ˈkɑtuˌsulku
katuvieri	ˈkɑtuˌʋie̯ri
kauaskantoisuus	ˈkɑu̯ɑsˌkɑntoi̯suːs
kauhakuormain	ˈkɑu̯hɑˌkuo̯rmɑi̯n
kauhistua	ˈkɑu̯histuɑˣ
kauhukertomus	ˈkɑu̯huˌkertomus
kauhupeli	ˈkɑu̯huˌpeli
kauin	ˈkɑu̯i̯n
kaukohakulaite	ˈkɑu̯koˌhɑkuˌlɑi̯teˣ
kaukokäsi	ˈkɑu̯koˌkæsi
kaukolämmitteinen	ˈkɑu̯koˌlæmːitːei̯nen
kaukomuisti	ˈkɑu̯koˌmui̯sti
kaukoputki	ˈkɑu̯koˌputki
kaukotaittoinen	ˈkɑu̯koˌtɑi̯tːoi̯nen
kaulailla	ˈkɑu̯lɑi̯lːɑˣ
kaularauta	ˈkɑu̯lɑˌrɑu̯tɑ
kaulia	ˈkɑu̯liɑˣ
kaulussaapas	ˈkɑu̯lusˌsɑːpɑs
kauneudenkaipuu	ˈkɑu̯neu̯denˌkɑi̯puː
kauneusnaamio	ˈkɑu̯neusˌnɑːmio
kaunissointinen	ˈkɑu̯nisˌsoi̯ntinen
kaunokirja	ˈkɑu̯noˌkirjɑ
kaunosilmä	ˈkɑu̯noˌsilmæ
kaupantekiäiset	ˈkɑu̯pɑnˌtekiæi̯set
kauppa-agentti	ˈkɑu̯pːɑˌ(ʔ)ɑɡentːi
kauppaherruus	ˈkɑu̯pːɑˌherːuːs
kauppakorkeakoulu	ˈkɑu̯pːɑˌkorkeɑˌkou̯lu
kauppalista	ˈkɑu̯pːɑˌlistɑ
kauppanimitys	ˈkɑu̯pːɑˌnimitys
kauppasalaisuus	ˈkɑu̯pːɑˌsɑlɑi̯suːs
kauppatuttava	ˈkɑu̯pːɑˌtutːɑʋɑ
kaupunginosayhdistys	ˈkɑu̯puŋːinˌosɑˌyhdistys
kaupunkiasunto	ˈkɑu̯puŋkiˌɑsunto
kaupunkikortti	ˈkɑu̯puŋkiˌkortːi
kaupunkilaisuus	ˈkɑu̯puŋkilɑi̯suːs
kaupunkimaistua	ˈkɑu̯puŋkimɑi̯stuɑˣ
kaupunkirakentaminen	ˈkɑu̯puŋkiˌrɑkentɑminen
kaupunkitila	ˈkɑu̯puŋkiˌtilɑ
kaurahattu	ˈkɑu̯rɑˌhɑtːu
kauranjyvä	ˈkɑu̯rɑnˌjyʋæ
kausaali-finaali	ˈkɑu̯sɑːliˌfinɑːli
kausiasuinpaikka	ˈkɑu̯siˌɑsui̯nˌpɑi̯kːɑ
kauttakulkukauppa	ˈkɑu̯tːɑˌkulkuˌkɑu̯pːɑ
kavahtaa	ˈkɑʋɑhtɑːˣ
kave	ˈkɑʋeˣ
kaveriporukka	ˈkɑʋeriˌporukːɑ
kaviteetti	ˈkɑʋiteːtːi
kebula	ˈkebulɑ
kehintä	ˈkehintæ
kehittyneisyys	ˈkehitːynei̯syːs
kehitysalue	ˈkehitysˌɑlueˣ
kehitysikä	ˈkehitysˌikæ
kehitysmaantiede	ˈkehitysˌmɑːnˌtie̯deˣ
kehityspsykologia	ˈkehitysˌpsykoˌloɡiɑ
kehitysvammatyö	ˈkehitysˌʋɑmːɑˌtyø̯
kehkeytyä	ˈkehkey̯tyæˣ
keho	ˈkeho
kehotushuuto	ˈkehotusˌhuːto
kehräs	ˈkehræs
kehräämö	ˈkehræːmø
kehuskeleminen	ˈkehuskeleminen
kehysliike	ˈkehysˌliːkeˣ
kehystää	ˈkehystæːˣ
kehälehti	ˈkehæˌlehti
kehäviittaus	ˈkehæˌʋiːtːɑus
keihästäminen	ˈkei̯hæstæminen
keijusto	ˈkei̯justo
keikka	ˈkei̯kːɑ
keila	ˈkei̯lɑ
keilarata	ˈkei̯lɑˌrɑtɑ
keino-	ˈkei̯no-
keinonahka	ˈkei̯noˌnɑhkɑ
keinovalo	ˈkei̯noˌʋɑlo
keinuttaa	ˈkei̯nutːɑːˣ
keisarikunta	ˈkei̯sɑriˌkuntɑ
keisarityyli	ˈkei̯sɑriˌtyːli
keitinpiirakka	ˈkei̯tinˌpiːrɑkːɑ
keittiöhenkilökunta	ˈkei̯tːiøˌheŋkiløˌkuntɑ
keittiösakset	ˈkei̯tːiøˌsɑkset
keittokirja	ˈkei̯tːoˌkirjɑ
keittomaali	ˈkei̯tːoˌmɑːli
keittotaso	ˈkei̯tːoˌtɑso
kekkuli	ˈkekːuli
keksijäätelö	ˈkeksiˌjæːtelø
keksinvarsi	ˈkeksinˌʋɑrsi
kela	ˈkelɑ
kelaus	ˈkelɑus
keljumainen	ˈkeljumɑi̯nen
kelkkatie	ˈkelkːɑˌtie̯
kellarikomero	ˈkelːɑriˌkomero
kellauttaminen	ˈkelːɑutːɑminen
kelli	ˈkelːi
kellojakso	ˈkelːoˌjɑkso
kellolaite	ˈkelːoˌlɑi̯teˣ
kellonmuotoinen	ˈkelːonˌmuo̯toi̯nen
kellonvitjat	ˈkelːonˌʋitjɑt
kelluke	ˈkelːukeˣ
kelluva	ˈkelːuʋɑ
kelohirsi	ˈkeloˌhirsi
kelpoinen	ˈkelpoi̯nen
kelta	ˈkeltɑ
keltakulta	ˈkeltɑˌkultɑ
keltapussihämähäkki	ˈkeltɑˌpusːiˌhæmæhækːi
kelteisillä	ˈkeltei̯silːæ
kelvinasteikko	ˈkelʋinˌɑstei̯kːo
kemianopettaja	ˈkemiɑnˌopetːɑjɑ
kemikaaliliike	ˈkemikɑːliˌliːkeˣ
kemiönsaarelainen	ˈkemiønˌsɑːrelɑi̯nen
kengittää	ˈkeŋːitːæːˣ
kengänkärki	ˈkeŋːænˌkærki
kenkku	ˈkeŋkːu
kenkälaatikko	ˈkeŋkæˌlɑːtikːo
kenneltoiminta	ˈkenːelˌtoi̯mintɑ
kenokaulainen	ˈkenoˌkɑu̯lɑi̯nen
kenraaliluutnantti	ˈkenrɑːliˌluːtnɑntːi
kenttäkalmisto	ˈkentːæˌkɑlmisto
kenttälaji	ˈkentːæˌlɑji
kenttäpakki	ˈkentːæˌpɑkːi
kenttäratsastus	ˈkentːæˌrɑtsɑstus
kenttäväki	ˈkentːæˌʋæki
kepittää	ˈkepitːæːˣ
keppostella	ˈkepːostelːɑˣ
keralle	ˈkerɑlːeˣ
keravalainen	ˈkerɑʋɑlɑi̯nen
keri	ˈkeri
kerjäillä	ˈkerjæi̯lːæˣ
kerjäys	ˈkerjæys
kermajauhe	ˈkermɑˌjɑu̯heˣ
kermamaito	ˈkermɑˌmɑi̯to
kermoittua	ˈkermoi̯tːuɑˣ
kerrannaisuus	ˈkerːɑnːɑi̯suːs
kerroksellisuus	ˈkerːokselːisuːs
kerroshyppy	ˈkerːosˌhypːy
kerrospinta-ala	ˈkerːosˌpintɑˌ(ʔ)ɑlɑ
kerrosteinen	ˈkerːostei̯nen
kerska	ˈkerskɑ
kerta-annos	ˈkertɑˌ(ʔ)ɑnːos
kertakäyttöhyödyke	ˈkertɑˌkæy̯tːøˌhyø̯dykeˣ
kertakäyttöpullo	ˈkertɑˌkæy̯tːøˌpulːo
kertarysäys	ˈkertɑˌrysæys
kertautuminen	ˈkertɑu̯tuminen
kertomarunollinen	ˈkertomɑˌrunolːinen
kerttu	ˈkertːu
keräilykivi	ˈkeræi̯lyˌkiʋi
keräymä	ˈkeræy̯mæ
kerääntyä	ˈkeræːntyæˣ
kesintä	ˈkesintæ
keskeisyys	ˈkeskei̯syːs
keskempänä	ˈkeskempænæ
keskeyksiin	ˈkeskeyksiːn
keskeytymätön	ˈkeskey̯tymætøn
keskiaasianpaimenkoira	ˈkeskiˌɑːsiɑnˌpɑi̯menˌkoi̯rɑ
keskiaste	ˈkeskiˌɑsteˣ
keskikaide	ˈkeskiˌkɑi̯deˣ
keskikorva	ˈkeskiˌkorʋɑ
keskiluokkaisuus	ˈkeskiˌluo̯kːɑi̯suːs
keskimurre	ˈkeskiˌmurːeˣ
keskiolutbaari	ˈkeskiˌolutˌbɑːri
keskipakopumppu	ˈkeskiˌpɑkoˌpumpːu
keskipääty	ˈkeskiˌpæːty
keskitiheys	ˈkeskiˌtiheys
keskittäytyminen	ˈkeskitːæy̯tyminen
keskivaiheilta	ˈkeskiˌʋɑi̯hei̯ltɑ
keskiviikko	ˈkeskiˌʋiːkːo
keskiyö	ˈkeskiˌyø̯
keskushermostollinen	ˈkeskusˌhermostolːinen
keskusliike	ˈkeskusˌliːkeˣ
keskuspaikka	ˈkeskusˌpɑi̯kːɑ
keskustalainen	ˈkeskustɑlɑi̯nen
keskustelualue	ˈkeskusteluˌɑlueˣ
keskusteluryhmä	ˈkeskusteluˌryhmæ
keskusvalvomo	ˈkeskusˌʋɑlʋomo
kessutteleminen	ˈkesːutːeleminen
kestohyödyke	ˈkestoˌhyø̯dykeˣ
kestopäällystää	ˈkestoˌpæːlːystæːˣ
kestävyysharjoittelu	ˈkestæʋyːsˌhɑrjoi̯tːelu
kestää	ˈkestæːˣ
kesyttyminen	ˈkesytːyminen
kesäasunto	ˈkesæˌɑsunto
kesäisesti	ˈkesæi̯sestiˣ
kesäkoti	ˈkesæˌkoti
kesäleski	ˈkesæˌleski
kesänaikainen	ˈkesænˌɑi̯kɑi̯nen
kesäpäivänseisaus	ˈkesæˌpæi̯ʋænˌsei̯sɑus
kesätapahtuma	ˈkesæˌtɑpɑhtumɑ
kesätyö	ˈkesæˌtyø̯
kesäöljy	ˈkesæˌøljy
ketjulukko	ˈketjuˌlukːo
ketjusilmukka	ˈketjuˌsilmukːɑ
ketkuilla	ˈketkui̯lːɑˣ
ketohanhikki	ˈketoˌhɑnhikːi
ketoruokavalio	ˈketoˌruo̯kɑˌʋɑlio
ketunmyrkky	ˈketunˌmyrkːy
ketuttaminen	ˈketutːɑminen
keuhkolaajentuma	ˈkeu̯hkoˌlɑːjentumɑ
keuhkorutto	ˈkeu̯hkoˌrutːo
keuhkoveritulppa	ˈkeu̯hkoˌʋeriˌtulpːɑ
keulaportti	ˈkeu̯lɑˌportːi
kevennellä	ˈkeʋenːelːæˣ
kevytbetoni	ˈkeʋytˌbetoni
kevytlevite	ˈkeʋytˌleʋiteˣ
kevytpiimä	ˈkeʋytˌpiːmæ
kevytvene	ˈkeʋytˌʋeneˣ
kevätaamu	ˈkeʋætˌɑːmu
kevätkausi	ˈkeʋætˌkɑu̯si
kevätmuoti	ˈkeʋætˌmuo̯ti
kevätsää	ˈkeʋætˌsæː
keynesiläisyys	ˈkey̯nesilæi̯syːs
kiasma	ˈkiɑsmɑ
kidnapata	ˈkidnɑpɑtɑˣ
kidusvaltimo	ˈkidusˌʋɑltimo
kiekaus	ˈkie̯kɑus
kiekonheitto	ˈkie̯konˌhei̯tːo
kieleke	ˈkie̯lekeˣ
kielenopiskelu	ˈkie̯lenˌopiskelu
kielentutkimus	ˈkie̯lenˌtutkimus
kieliasu	ˈkie̯liˌɑsu
kielikohtainen	ˈkie̯liˌkohtɑi̯nen
kielinen	ˈkie̯linen
kieliperhe	ˈkie̯liˌperheˣ
kieliresurssi	ˈkie̯liˌresursːi
kielitaito	ˈkie̯liˌtɑi̯to
kielitunne	ˈkie̯liˌtunːeˣ
kieliyhteisö	ˈkie̯liˌyhtei̯sø
kieltenopetus	ˈkie̯ltenˌopetus
kieltäymyksellinen	ˈkie̯ltæy̯mykselːinen
kiepaus	ˈkie̯pɑus
kiepsaus	ˈkie̯psɑus
kieroluonteinen	ˈkie̯roˌluo̯ntei̯nen
kierrekansi	ˈkie̯rːeˣˌkɑnsi
kierremutteri	ˈkie̯rːeˣˌmutːeri
kierretyökalu	ˈkie̯rːeˣˌtyø̯ˌkɑlu
kierroslukumittari	ˈkie̯rːosˌlukuˌmitːɑri
kierrätyslasi	ˈkie̯rːætysˌlɑsi
kierteitystappi	ˈkie̯rtei̯tysˌtɑpːi
kiertokasvi	ˈkie̯rtoˌkɑsʋi
kiertoliike	ˈkie̯rtoˌliːkeˣ
kiertoprosessi	ˈkie̯rtoˌprosesːi
kiertoviljely	ˈkie̯rtoˌʋiljely
kiertää	ˈkie̯rtæːˣ
kieryys	ˈkie̯ryːs
kietaisuhame	ˈkie̯tɑi̯suˌhɑmeˣ
kihara	ˈkihɑrɑ
kihartaminen	ˈkihɑrtɑminen
kihlakunnankäräjät	ˈkihlɑˌkunːɑnˌkæræjæt
kihlautua	ˈkihlɑu̯tuɑˣ
kihomato	ˈkihoˌmɑto
kiidättäminen	ˈkiːdætːæminen
kiihdytysauto	ˈkiːhdytysˌɑu̯to
kiihkoilla	ˈkiːhkoi̯lːɑˣ
kiihkomielinen	ˈkiːhkoˌmie̯linen
kiihottaa	ˈkiːhotːɑːˣ
kiihotusaine	ˈkiːhotusˌɑi̯neˣ
kiihtyvyys	ˈkiːhtyʋyːs
kiikku	ˈkiːkːu
kiilakivi	ˈkiːlɑˌkiʋi
kiillellä	ˈkiːlːelːæˣ
kiiltokuva	ˈkiːltoˌkuʋɑ
kiiltopinta	ˈkiːltoˌpintɑ
kiiltäväpintainen	ˈkiːltæʋæˌpintɑi̯nen
kiimainen	ˈkiːmɑi̯nen
kiinalaisnainen	ˈkiːnɑlɑi̯sˌnɑi̯nen
kiinnempänä	ˈkiːnːempænæ
kiinnitin	ˈkiːnːitin
kiinnitysköysi	ˈkiːnːitysˌkøy̯si
kiinnityssuola	ˈkiːnːitysˌsuo̯lɑ
kiinteistö	ˈkiːntei̯stø
kiinteistöluettelo	ˈkiːntei̯støˌluetːelo
kiinteistönpito	ˈkiːntei̯stønˌpito
kiinteistötaloustiede	ˈkiːntei̯støˌtɑlousˌtie̯deˣ
kiintiöinti	ˈkiːntiøi̯nti
kiintoisasti	ˈkiːntoi̯sɑstiˣ
kiintoluku	ˈkiːntoˌluku
kiintorasti	ˈkiːntoˌrɑsti
kiintynyt	ˈkiːntynyt
kiirastorstai	ˈkiːrɑsˌtorstɑi̯
kiireetön	ˈkiːreːtøn
kiiriä	ˈkiːriæˣ
kiisseli	ˈkiːsːeli
kiistattomuus	ˈkiːstɑtːomuːs
kiisu	ˈkiːsu
kiitollisuudenvelka	ˈkiːtolːisuːdenˌʋelkɑ
kiitosrukous	ˈkiːtosˌrukous
kiittää	ˈkiːtːæːˣ
kiivasluonteinen	ˈkiːʋɑsˌluo̯ntei̯nen
kiivilintu	ˈkiːʋiˌlintu
kikkelikuva	ˈkikːeliˌkuʋɑ
kili	ˈkili
kiljahdella	ˈkiljɑhdelːɑˣ
kiljuva	ˈkiljuʋɑ
killeri	ˈkilːeri
killutin	ˈkilːutin
kilometreittäin	ˈkiloˌmetrei̯tːæi̯n
kilowatti	ˈkiloˌwɑtːi
kilpahiihtäjä	ˈkilpɑˌhiːhtæjæ
kilpailukausi	ˈkilpɑi̯luˌkɑu̯si
kilpailuneuvosto	ˈkilpɑi̯luˌneu̯ʋosto
kilpailutalous	ˈkilpɑi̯luˌtɑlous
kilpakävelijä	ˈkilpɑˌkæʋelijæ
kilparatsu	ˈkilpɑˌrɑtsu
kilpavene	ˈkilpɑˌʋeneˣ
kilpikonnaliemi	ˈkilpiˌkonːɑˌlie̯mi
kilpirusto	ˈkilpiˌrusto
kiltteys	ˈkiltːeys
kimakasti	ˈkimɑkɑstiˣ
kimallus	ˈkimɑlːus
kimeä-ääninen	ˈkimeæˌ(ʔ)æːninen
kimmastua	ˈkimːɑstuɑˣ
kimmomoduuli	ˈkimːoˌmoduːli
kimpaantua	ˈkimpɑːntuɑˣ
kimppuun	ˈkimpːuːn
kinailla	ˈkinɑi̯lːɑˣ
kinkaju	ˈkiŋkɑju
kinkkumunakas	ˈkiŋkːuˌmunɑkɑs
kinnaspari	ˈkinːɑsˌpɑri
kinostuma	ˈkinostumɑ
kinuskikastike	ˈkinuskiˌkɑstikeˣ
kipaisu	ˈkipɑi̯su
kiperästi	ˈkiperæstiˣ
kipinäverkko	ˈkipinæˌʋerkːo
kipparinlakki	ˈkipːɑrinˌlɑkːi
kippivaunu	ˈkipːiˌʋɑu̯nu
kippuranenäinen	ˈkipːurɑˌnenæi̯nen
kipsikuva	ˈkipsiˌkuʋɑ
kipukynnys	ˈkipuˌkynːys
kirahvi	ˈkirɑhʋi
kireästi	ˈkireæstiˣ
kiristely	ˈkiristely
kiristyä	ˈkiristyæˣ
kirjaamismaksu	ˈkirjɑːmisˌmɑksu
kirjailla	ˈkirjɑi̯lːɑˣ
kirjainmerkki	ˈkirjɑi̯nˌmerkːi
kirjakauppa	ˈkirjɑˌkɑu̯pːɑ
kirjallinen	ˈkirjɑlːinen
kirjallisuushistoriallinen	ˈkirjɑlːisuːsˌhistoriɑlːinen
kirjankustannus	ˈkirjɑnˌkustɑnːus
kirjanpitojärjestelmä	ˈkirjɑnˌpitoˌjærjestelmæ
kirjanpitovihko	ˈkirjɑnˌpitoˌʋihko
kirjapainotekniikka	ˈkirjɑˌpɑi̯noˌtekniːkːɑ
kirjasinperhe	ˈkirjɑsinˌperheˣ
kirjastokorvaus	ˈkirjɑstoˌkorʋɑus
kirjastotalo	ˈkirjɑstoˌtɑlo
kirjatäi	ˈkirjɑˌtæi̯
kirjavuus	ˈkirjɑʋuːs
kirjekerho	ˈkirjeˣˌkerho
kirjepaperilehtiö	ˈkirjeˣˌpɑperiˌlehtiø
kirjo	ˈkirjo
kirjoittajapiiri	ˈkirjoi̯tːɑjɑˌpiːri
kirjoituskilpailu	ˈkirjoi̯tusˌkilpɑi̯lu
kirjoituspää	ˈkirjoi̯tusˌpæː
kirjokansi	ˈkirjoˌkɑnsi
kirjotähti	ˈkirjoˌtæhti
kirkassolukerros	ˈkirkɑsˌsoluˌkerːos
kirkasvetinen	ˈkirkɑsˌʋetinen
kirkkohallinto	ˈkirkːoˌhɑlːinto
kirkkokolehti	ˈkirkːoˌkolehti
kirkkomaalari	ˈkirkːoˌmɑːlɑri
kirkkorauha	ˈkirkːoˌrɑu̯hɑ
kirkkotekstiili	ˈkirkːoˌtekstiːli
kirkollisesti	ˈkirkolːisestiˣ
kirkonmeno	ˈkirkonˌmeno
kirkottaa	ˈkirkotːɑːˣ
kiroileminen	ˈkiroi̯leminen
kirpeäsanainen	ˈkirpeæˌsɑnɑi̯nen
kirsi	ˈkirsi
kirskaus	ˈkirskɑus
kirurgia	ˈkirurɡiɑ
kirvellys	ˈkirʋelːys
kirvesvarsi	ˈkirʋesˌʋɑrsi
kisatyttö	ˈkisɑˌtytːø
kiskopari	ˈkiskoˌpɑri
kissa-allergia	ˈkisːɑˌ(ʔ)ɑlːerɡiɑ
kissanmaito	ˈkisːɑnˌmɑi̯to
kisälli	ˈkisælːi
kitaransoitto	ˈkitɑrɑnˌsoi̯tːo
kiteyttäminen	ˈkiteytːæminen
kitkainen	ˈkitkɑi̯nen
kitkeminen	ˈkitkeminen
kitosaani	ˈkitosɑːni
kitti	ˈkitːi
kituliaisuus	ˈkituliɑi̯suːs
kiukkuinen	ˈkiu̯kːui̯nen
kiukutella	ˈkiu̯kutelːɑˣ
kiuruveteläinen	ˈkiu̯ruˌʋetelæi̯nen
kiusanteko	ˈkiu̯sɑnˌteko
kivellinen	ˈkiʋelːinen
kivenmukura	ˈkiʋenˌmukurɑ
kivennäisravinne	ˈkiʋenːæi̯sˌrɑʋinːeˣ
kivettymä	ˈkiʋetːymæ
kiviarkku	ˈkiʋiˌɑrkːu
kivihiiliesiintymä	ˈkiʋiˌhiːliˌesiːntymæ
kivijalkapaita	ˈkiʋiˌjɑlkɑˌpɑi̯tɑ
kivikatu	ˈkiʋiˌkɑtu
kivikkoranta	ˈkiʋikːoˌrɑntɑ
kivilaituri	ˈkiʋiˌlɑi̯turi
kivimöhkäle	ˈkiʋiˌmøhkæleˣ
kivipari	ˈkiʋiˌpɑri
kivipora	ˈkiʋiˌporɑ
kivirakka	ˈkiʋiˌrɑkːɑ
kivisammal	ˈkiʋiˌsɑmːɑl
kivistäminen	ˈkiʋistæminen
kivitavara	ˈkiʋiˌtɑʋɑrɑ
kivityöläinen	ˈkiʋiˌtyø̯læi̯nen
kivulloisuus	ˈkiʋulːoi̯suːs
kiväärikomppania	ˈkiʋæːriˌkompːɑniɑ
kivääriote	ˈkiʋæːriˌoteˣ
klassifioiminen	ˈklɑsːifioi̯minen
klementiini	ˈklementiːni
kliimaksi	ˈkliːmɑksi
klinozoisiitti	ˈklinoˌtsoi̯siːtːi
klooninen	ˈkloːninen
klorogeenihappo	ˈkloroɡeːniˌhɑpːo
knalli	ˈknɑlːi
kodanpohja	ˈkodɑnˌpohjɑ
kodinohjausjärjestelmä	ˈkodinˌohjɑusˌjærjestelmæ
koeala	ˈkoeˣˌɑlɑ
koekierros	ˈkoeˣˌkie̯rːos
koenumero	ˈkoeˣˌnumero
koetehdas	ˈkoeˣˌtehdɑs
koetteelle	ˈkoetːeːlːeˣ
koeäänestys	ˈkoeˣˌæːnestys
kohaus	ˈkohɑus
kohde	ˈkohdeˣ
kohdevalaisin	ˈkohdeˣˌʋɑlɑi̯sin
kohdunlaskeuma	ˈkohdunˌlɑskeu̯mɑ
kohelo	ˈkohelo
kohinasalpa	ˈkohinɑˌsɑlpɑ
kohmetus	ˈkohmetus
kohokkikasvi	ˈkohokːiˌkɑsʋi
kohopainokone	ˈkohoˌpɑi̯noˌkoneˣ
kohottua	ˈkohotːuɑˣ
kohtalaisesti	ˈkohtɑlɑi̯sestiˣ
kohtalotoveri	ˈkohtɑloˌtoʋeri
kohteliaisuussääntö	ˈkohteliɑi̯suːsˌsæːntø
kohtuudenmukainen	ˈkohtuːdenˌmukɑi̯nen
kohtuuttomasti	ˈkohtuːtːomɑstiˣ
koilliskolkka	ˈkoi̯lːisˌkolkːɑ
koipeliini	ˈkoi̯peliːni
koirahyökkäys	ˈkoi̯rɑˌhyø̯kːæys
koirankuje	ˈkoi̯rɑnˌkujeˣ
koiranäyttely	ˈkoi̯rɑˌnæy̯tːely
koiravahti	ˈkoi̯rɑˌʋɑhti
koittaminen	ˈkoi̯tːɑminen
koivukuja	ˈkoi̯ʋuˌkujɑ
koivunurpu	ˈkoi̯ʋunˌurpu
kojepistoke	ˈkojeˣˌpistokeˣ
kokapensas	ˈkokɑˌpensɑs
kokeilukoulu	ˈkokei̯luˌkou̯lu
kokemäkeläinen	ˈkokeˌmækelæi̯nen
kokkaaminen	ˈkokːɑːminen
kokko	ˈkokːo
kokoaikainen	ˈkokoˌɑi̯kɑi̯nen
kokoelmatyö	ˈkokoelmɑˌtyø̯
kokoliha	ˈkokoˌlihɑ
kokonaisenergia	ˈkokonɑi̯sˌenerɡiɑ
kokonaisilmaisu	ˈkokonɑi̯sˌilmɑi̯su
kokonaisnäkemys	ˈkokonɑi̯sˌnækemys
kokonaistappio	ˈkokonɑi̯sˌtɑpːio
kokonaisvaltainen	ˈkokonɑi̯sˌʋɑltɑi̯nen
kokoojakatu	ˈkokoːjɑˌkɑtu
kokoonpano	ˈkokoːnˌpɑno
kokoontumislaki	ˈkokoːntumisˌlɑki
kokopäiväinen	ˈkokoˌpæi̯ʋæi̯nen
kokotauko	ˈkokoˌtɑu̯ko
kokouspalkkio	ˈkokousˌpɑlkːio
kokovartalopeili	ˈkokoˌʋɑrtɑloˌpei̯li
koksiitti	ˈkoksiːtːi
kolahtaminen	ˈkolɑhtɑminen
kolaroida	ˈkolɑroi̯dɑˣ
kolerabakteeri	ˈkolerɑˌbɑkteːri
kolhiutua	ˈkolhiu̯tuɑˣ
koliseminen	ˈkoliseminen
kolkko	ˈkolkːo
kollarit	ˈkolːɑrit
kollektivisti	ˈkolːektiʋisti
kollotus	ˈkolːotus
kolmesataa	ˈkolmeˌsɑtɑː
kolmikulmio	ˈkolmiˌkulmio
kolmioleipä	ˈkolmioˌlei̯pæ
kolmittain	ˈkolmitːɑi̯n
koloa	ˈkoloɑ
koloradokuoriainen	ˈkolorɑdoˌkuo̯riɑi̯nen
koloristinen	ˈkoloristinen
kolttostella	ˈkoltːostelːɑˣ
kombinaatio	ˈkombinɑːtio
komediakirjallisuus	ˈkomediɑˌkirjɑlːisuːs
komentajamerkki	ˈkomentɑjɑˌmerkːi
komentosarja	ˈkomentoˌsɑrjɑ
komissio	ˈkomisːio
komitentti	ˈkomitentːi
kommentoida	ˈkomːentoi̯dɑˣ
kommunikatiivinen	ˈkomːunikɑtiːʋinen
kommunistisuus	ˈkomːunistisuːs
komparatiivi	ˈkompɑrɑtiːʋi
kompensatorinen	ˈkompensɑtorinen
kompleksiyhdiste	ˈkompleksiˌyhdisteˣ
kompostimulta	ˈkompostiˌmultɑ
kompromissiehdotus	ˈkompromisːiˌehdotus
kondensointi	ˈkondensoi̯nti
kondorikotka	ˈkondoriˌkotkɑ
koneenasennus	ˈkoneːnˌɑsenːus
koneikko	ˈkonei̯kːo
konekirjoitettu	ˈkoneˣˌkirjoi̯tetːu
konekoodinen	ˈkoneˣˌkoːdinen
konemainen	ˈkonemɑi̯nen
koneosuuskunta	ˈkoneˣˌosuːsˌkuntɑ
konepistoolisuihku	ˈkoneˣˌpistoːliˌsui̯hku
konesali	ˈkoneˣˌsɑli
konetiskiaine	ˈkoneˣˌtiskiˌɑi̯neˣ
koneöljy	ˈkoneˣˌøljy
konfliktiromaani	ˈkonfliktiˌromɑːni
kongressitalo	ˈkoŋresːiˌtɑlo
konjunktioton	ˈkonjuŋktioton
konkkaronkka	ˈkoŋkːɑˌroŋkːɑ
konkretisoituminen	ˈkoŋkretisoi̯tuminen
konkurssisaatava	ˈkoŋkursːiˌsɑːtɑʋɑ
konnantyö	ˈkonːɑnˌtyø̯
konsekutiivisuus	ˈkonsekutiːʋisuːs
konsernitilinpäätös	ˈkonserniˌtilinˌpæːtøs
konserttiohjelma	ˈkonsertːiˌohjelmɑ
konservointimenetelmä	ˈkonserʋoi̯ntiˌmenetelmæ
konsonanttiloppuinen	ˈkonsonɑntːiˌlopːui̯nen
konstruktivistinen	ˈkonstruktiʋistinen
konsulikyyti	ˈkonsuliˌkyːti
kontakti-ilmoitus	ˈkontɑktiˌ(ʔ)ilmoi̯tus
kontallaan	ˈkontɑlːɑːn
kontinentti	ˈkontinentːi
kontortamänty	ˈkontortɑˌmænty
kontrasti	ˈkontrɑsti
kontrolloimattomasti	ˈkontrolːoi̯mɑtːomɑstiˣ
konttilasti	ˈkontːiˌlɑsti
konttorinhoitaja	ˈkontːorinˌhoi̯tɑjɑ
konvergentti	ˈkonʋerɡentːi
koodaus	ˈkoːdɑus
koodinpätkä	ˈkoːdinˌpætkæ
kookas	ˈkoːkɑs
kookosöljy	ˈkoːkosˌøljy
koomisuus	ˈkoːmisuːs
koordinaatisto	ˈkoːrdinɑːtisto
koossapysyvä	ˈkoːsːɑˌpysyʋæ
koota	ˈkoːtɑˣ
kopautus	ˈkopɑu̯tus
kopioija	ˈkopioi̯jɑ
kopisuttaa	ˈkopisutːɑːˣ
koppero	ˈkopːero
kopsahdella	ˈkopsɑhdelːɑˣ
koputtelu	ˈkoputːelu
korallihiekka	ˈkorɑlːiˌhie̯kːɑ
koreasti	ˈkoreɑstiˣ
korihuonekalu	ˈkoriˌhuo̯neˣˌkɑlu
korista	ˈkoristɑˣ
koristekrassi	ˈkoristeˣˌkrɑsːi
koristemaalaus	ˈkoristeˣˌmɑːlɑus
koristeveistäjä	ˈkoristeˣˌʋei̯stæjæ
korjata	ˈkorjɑtɑˣ
korjausmerkki	ˈkorjɑusˌmerkːi
korjuri	ˈkorjuri
korkea	ˈkorkeɑ
korkeakiiltoinen	ˈkorkeɑˌkiːltoi̯nen
korkeakouluneuvos	ˈkorkeɑˌkou̯luˌneu̯ʋos
korkeakulttuurinen	ˈkorkeɑˌkultːuːrinen
korkeatehoinen	ˈkorkeɑˌtehoi̯nen
korkeusennätys	ˈkorkeusˌenːætys
korkeusvaihtelu	ˈkorkeusˌʋɑi̯htelu
korkkari	ˈkorkːɑri
korkkipyssy	ˈkorkːiˌpysːy
korkokenkä	ˈkorkoˌkeŋkæ
korkopolitiikka	ˈkorkoˌpolitiːkːɑ
korkuinen	ˈkorkui̯nen
korokekansi	ˈkorokeˣˌkɑnsi
koronavirus	ˈkoronɑˌʋi(ː)rus
korostekynä	ˈkorosteˣˌkynæ
korpikenttä	ˈkorpiˌkentːæ
korpisara	ˈkorpiˌsɑrɑ
korppu	ˈkorpːu
korrepetiittori	ˈkorːepetiːtːori
korsikanritari	ˈkorsikɑnˌritɑri
korskeus	ˈkorskeus
kortinlukija	ˈkortinˌlukijɑ
kortsu	ˈkortsu
kortteliravintola	ˈkortːeliˌrɑʋintolɑ
korttilaatikko	ˈkortːiˌlɑːtikːo
korttitieto	ˈkortːiˌtie̯to
koruneula	ˈkoruˌneu̯lɑ
koruteollisuus	ˈkoruˌteolːisuːs
korvakipu	ˈkorʋɑˌkipu
korvalusikka	ˈkorʋɑˌlusikːɑ
korvaruisku	ˈkorʋɑˌrui̯sku
korvatautioppi	ˈkorʋɑˌtɑu̯tiˌopːi
korvauskäsittely	ˈkorʋɑusˌkæsitːely
korventaa	ˈkorʋentɑːˣ
kosia	ˈkosiɑˣ
koska	ˈkoskɑ
kosketin	ˈkosketin
kosketusaisti	ˈkosketusˌɑi̯sti
kosmetiikkaosasto	ˈkosmetiːkːɑˌosɑsto
kosovolaisuus	ˈkosoʋolɑi̯suːs
kosteuseristys	ˈkosteusˌeristys
kostonhalu	ˈkostonˌhɑlu
kostuttaa	ˈkostutːɑːˣ
koteloida	ˈkoteloi̯dɑˣ
kotelopuku	ˈkoteloˌpuku
kotialue	ˈkotiˌɑlueˣ
kotieläintauti	ˈkotiˌelæi̯nˌtɑu̯ti
kotiinlähtö	ˈkotiːnˌlæhtø
kotikielenopettaja	ˈkotiˌkie̯lenˌopetːɑjɑ
kotikuri	ˈkotiˌkuri
kotilo	ˈkotilo
kotimaanmatkailu	ˈkotiˌmɑːnˌmɑtkɑi̯lu
kotiminä	ˈkotiˌminæ
kotiopetus	ˈkotiˌopetus
kotipihlaja	ˈkotiˌpihlɑjɑ
kotisairaala	ˈkotiˌsɑi̯rɑːlɑ
kotiseutuneuvos	ˈkotiˌseu̯tuˌneu̯ʋos
kotitakki	ˈkotiˌtɑkːi
kotitalousoppilaitos	ˈkotiˌtɑlousˌopːiˌlɑi̯tos
kotitarvekalastus	ˈkotiˌtɑrʋeˣˌkɑlɑstus
kotitienoo	ˈkotiˌtie̯noː
kotiverkko	ˈkotiˌʋerkːo
kotkankatse	ˈkotkɑnˌkɑtseˣ
koto	ˈkoto
kotomaa	ˈkotoˌmɑː
kottarainen	ˈkotːɑrɑi̯nen
koukeroinen	ˈkou̯keroi̯nen
koukistusliike	ˈkou̯kistusˌliːkeˣ
koukkunokka	ˈkou̯kːuˌnokːɑ
koulita	ˈkou̯litɑˣ
kouluateria	ˈkou̯luˌɑteriɑ
kouluhistoriikki	ˈkou̯luˌhistoriːkːi
koulukeittiö	ˈkou̯luˌkei̯tːiø
koulukuraattori	ˈkou̯luˌkurɑːtːori
koululaiskieli	ˈkou̯lulɑi̯sˌkie̯li
koululakko	ˈkou̯luˌlɑkːo
koulumainen	ˈkou̯lumɑi̯nen
koulunkäynti	ˈkou̯lunˌkæy̯nti
koulupakko	ˈkou̯luˌpɑkːo
kouluradio	ˈkou̯luˌrɑdio
koulusivistys	ˈkou̯luˌsiʋistys
koulutieto	ˈkou̯luˌtie̯to
koulutuksellinen	ˈkou̯lutukselːinen
koulutuslentokone	ˈkou̯lutusˌlentoˌkoneˣ
koulutuspolitiikka	ˈkou̯lutusˌpolitiːkːɑ
koulutustarve	ˈkou̯lutusˌtɑrʋeˣ
kouluvaikeus	ˈkou̯luˌʋɑi̯keus
kouluympäristö	ˈkou̯luˌympæristø
kouri	ˈkou̯ri
kouristuskohtaus	ˈkou̯ristusˌkohtɑus
kovaiskuinen	ˈkoʋɑˌiskui̯nen
kovakuorinen	ˈkoʋɑˌkuo̯rinen
kovanaamainen	ˈkoʋɑˌnɑːmɑi̯nen
kovarianssimatriisi	ˈkoʋɑriɑnsːiˌmɑtriːsi
kovaäänisyys	ˈkoʋɑˌæːnisyːs
koverokirves	ˈkoʋeroˌkirʋes
kovettaa	ˈkoʋetːɑːˣ
kovuuskoe	ˈkoʋuːsˌkoeˣ
kramppi	ˈkrɑmpːi
kravatti	ˈkrɑʋɑtːi
krematoiminen	ˈkremɑtoi̯minen
kriisikokous	ˈkriːsiˌkokous
kriminologia	ˈkriminoˌloɡiɑ
kritisoiminen	ˈkritisoi̯minen
kromaliini	ˈkromɑliːni
kromosomistomutaatio	ˈkromosomistoˌmutɑːtio
krouvi	ˈkrou̯ʋi
kruuna	ˈkruːnɑ
krypta	ˈkryptɑ
ksantaani	ˈksɑntɑːni
kudelma	ˈkudelmɑ
kudosopillinen	ˈkudosˌopilːinen
kuherrus	ˈkuherːus
kuhmura	ˈkuhmurɑ
kuidutin	ˈkui̯dutin
kuikuilu	ˈkui̯kui̯lu
kuiskata	ˈkui̯skɑtɑˣ
kuisti	ˈkui̯sti
kuituaine	ˈkui̯tuˌɑi̯neˣ
kuitusuunta	ˈkui̯tuˌsuːntɑ
kuivaharjaus	ˈkui̯ʋɑˌhɑrjɑus
kuivakka	ˈkui̯ʋɑkːɑ
kuivamuuri	ˈkui̯ʋɑˌmuːri
kuivashampoo	ˈkui̯ʋɑˌʃɑmp(ː)oː
kuivatuskaappi	ˈkui̯ʋɑtusˌkɑːpːi
kuivausyksikkö	ˈkui̯ʋɑusˌyksikːø
kuja	ˈkujɑ
kukahdus	ˈkukɑhdus
kukinto	ˈkukinto
kukkakauppa	ˈkukːɑˌkɑu̯pːɑ
kukkaköynnös	ˈkukːɑˌkøy̯nːøs
kukkameri	ˈkukːɑˌmeri
kukkaseppele	ˈkukːɑˌsepːeleˣ
kukkaterttu	ˈkukːɑˌtertːu
kukkula	ˈkukːulɑ
kukkuroilleen	ˈkukːuroi̯lːeːn
kuku	ˈkukuˣ
kulissien takana	ˈkulisːien ˈtɑkɑnɑ
kuljettua	ˈkuljetːuɑˣ
kuljetuskone	ˈkuljetusˌkoneˣ
kuljetusneuvo	ˈkuljetusˌneu̯ʋo
kuljetusvaunu	ˈkuljetusˌʋɑu̯nu
kulku	ˈkulku
kulkumies	ˈkulkuˌmie̯s
kulkuri	ˈkulkuri
kulkuväylä	ˈkulkuˌʋæy̯læ
kullankeltainen	ˈkulːɑnˌkeltɑi̯nen
kulli	ˈkulːi
kulmahiomakone	ˈkulmɑˌhiomɑˌkoneˣ
kulmakorkeus	ˈkulmɑˌkorkeus
kulmamittari	ˈkulmɑˌmitːɑri
kulmasahauslaite	ˈkulmɑˌsɑhɑusˌlɑi̯teˣ
kulmaviivain	ˈkulmɑˌʋiːʋɑi̯n
kulo	ˈkulo
kultadublee	ˈkultɑˌdubleː
kultajauhe	ˈkultɑˌjɑu̯heˣ
kultakimpale	ˈkultɑˌkimpɑleˣ
kultaköynnös	ˈkultɑˌkøy̯nːøs
kultamalmi	ˈkultɑˌmɑlmi
kultapitoisuus	ˈkultɑˌpitoi̯suːs
kultaseppä	ˈkultɑˌsepːæ
kultavaaka	ˈkultɑˌʋɑːkɑ
kultivoitua	ˈkultiʋoi̯tuɑˣ
kulttuuri-imperialismi	ˈkultːuːriˌ(ʔ)imperiɑlismi
kulttuuriero	ˈkultːuːriˌero
kulttuurijärjestö	ˈkultːuːriˌjærjestø
kulttuurikriitikko	ˈkultːuːriˌkriːtikːo
kulttuurimaisema	ˈkultːuːriˌmɑi̯semɑ
kulttuuripalvelu	ˈkultːuːriˌpɑlʋelu
kulttuurirahasto	ˈkultːuːriˌrɑhɑsto
kulttuurisihteeri	ˈkultːuːriˌsihteːri
kulttuuritiede	ˈkultːuːriˌtie̯deˣ
kulttuuriyhteys	ˈkultːuːriˌyhteys
kulumiskestävyys	ˈkulumisˌkestæʋyːs
kuluttaja-asiamies	ˈkulutːɑjɑˌ(ʔ)ɑsiɑˌmie̯s
kuluttajansuoja	ˈkulutːɑjɑnˌsuo̯jɑ
kuluttajavalituslautakunta	ˈkulutːɑjɑˌʋɑlitusˌlɑu̯tɑˌkuntɑ
kulutuskriittinen	ˈkulutusˌkriːtːinen
kulutusverotus	ˈkulutusˌʋerotus
kumarainen	ˈkumɑrɑi̯nen
kumaruus	ˈkumɑruːs
kumihihna	ˈkumiˌhihnɑ
kumimaito	ˈkumiˌmɑi̯to
kumipuku	ˈkumiˌpuku
kumista	ˈkumistɑˣ
kumittuminen	ˈkumitːuminen
kummanne	ˈkumːɑnːeˣ
kummi	ˈkumːi
kummitus	ˈkumːitus
kumollaan	ˈkumolːɑːn
kumoushanke	ˈkumousˌhɑŋkeˣ
kumpi	ˈkumpi
kumpukerrospilvi	ˈkumpuˌkerːosˌpilʋi
kuna	ˈkunɑ
kuningasidea	ˈkuniŋːɑsˌideɑ
kuningatar	ˈkuniŋːɑtɑr
kuninkuuskilpailu	ˈkuniŋkuːsˌkilpɑi̯lu
kunnalliskertomus	ˈkunːɑlːisˌkertomus
kunnallistaa	ˈkunːɑlːistɑːˣ
kunnaneläinlääkäri	ˈkunːɑnˌelæi̯nˌlæːkæri
kunnantoimisto	ˈkunːɑnˌtoi̯misto
kunnia	ˈkunːiɑ
kunniakonsulaatti	ˈkunːiɑˌkonsulɑːtːi
kunnianarkuus	ˈkunːiɑnˌɑrkuːs
kunniapalkinto	ˈkunːiɑˌpɑlkinto
kunniatuomioistuin	ˈkunːiɑˌtuo̯mioˌistui̯n
kunnioittaa	ˈkunːioi̯tːɑːˣ
kunnossa	ˈkunːosːɑ
kunnoton	ˈkunːoton
kuntakonserni	ˈkuntɑˌkonserni
kunteus	ˈkunteus
kuntoilla	ˈkuntoi̯lːɑˣ
kuntokävely	ˈkuntoˌkæʋely
kuntorekki	ˈkuntoˌrekːi
kuntoutuslaitos	ˈkuntou̯tusˌlɑi̯tos
kuohari	ˈkuo̯hɑri
kuohukerma	ˈkuo̯huˌkermɑ
kuokka	ˈkuo̯kːɑ
kuolema	ˈkuo̯lemɑ
kuolemanloukku	ˈkuo̯lemɑnˌlou̯kːu
kuolemanvaaraluku	ˈkuo̯lemɑnˌʋɑːrɑˌluku
kuoletussuunnitelma	ˈkuo̯letusˌsuːnːitelmɑ
kuolinikä	ˈkuo̯linˌikæ
kuolinsanoma	ˈkuo̯linˌsɑnomɑ
kuolleisuustilasto	ˈkuo̯lːei̯suːsˌtilɑsto
kuomullinen	ˈkuo̯mulːinen
kuopanne	ˈkuo̯pɑnːeˣ
kuoppakeramiikka	ˈkuo̯pːɑˌkerɑmiːkːɑ
kuoreutuma	ˈkuo̯reu̯tumɑ
kuorilevy	ˈkuo̯riˌleʋy
kuoriperuna	ˈkuo̯riˌperunɑ
kuorma-auto	ˈkuo̯rmɑˌ(ʔ)ɑu̯to
kuormantasaus	ˈkuo̯rmɑnˌtɑsɑus
kuormittain	ˈkuo̯rmitːɑi̯n
kuorolainen	ˈkuo̯rolɑi̯nen
kuorrutussuklaa	ˈkuo̯rːutusˌsuklɑː
kuosillinen	ˈkuo̯silːinen
kuparikaiverros	ˈkupɑriˌkɑi̯ʋerːos
kuparipelti	ˈkupɑriˌpelti
kuparityö	ˈkupɑriˌtyø̯
kupeksia	ˈkupeksiɑˣ
kuplapakkaus	ˈkuplɑˌpɑkːɑus
kuponkivihko	ˈkupoŋkiˌʋihko
kuppatauti	ˈkupːɑtɑu̯ti
kupponen	ˈkupːonen
kupu	ˈkupu
kuraaminen	ˈkurɑːminen
kurata	ˈkurɑtɑˣ
kurenauha	ˈkureˣˌnɑu̯hɑ
kurillaan	ˈkurilːɑːn
kurinpitoasia	ˈkurinˌpitoˌɑsiɑ
kuriseminen	ˈkuriseminen
kurittaja	ˈkuritːɑjɑ
kurjasti	ˈkurjɑstiˣ
kurjistumisteoria	ˈkurjistumisˌteoriɑ
kurkkia	ˈkurkːiɑˣ
kurkkutauti	ˈkurkːuˌtɑu̯ti
kurkunpää	ˈkurkunˌpæː
kurmu	ˈkurmu
kurpitsajuhla	ˈkurpitsɑˌjuhlɑ
kursailematon	ˈkursɑi̯lemɑton
kursorinen	ˈkursorinen
kurssikokonaisuus	ˈkursːiˌkokonɑi̯suːs
kurssitus	ˈkursːitus
kurttukaali	ˈkurtːuˌkɑːli
kusaiseminen	ˈkusɑi̯seminen
kusiaispesä	ˈkusiɑi̯sˌpesæ
kuskipukki	ˈkuskiˌpukːi
kustannusjohtaja	ˈkustɑnːusˌjohtɑjɑ
kustannussopimus	ˈkustɑnːusˌsopimus
kuteille	ˈkutei̯lːeˣ
kutiseva	ˈkutiseʋɑ
kutistua	ˈkutistuɑˣ
kutkuta	ˈkutkutɑˣ
kutomosali	ˈkutomoˌsɑli
kutsukoodi	ˈkutsuˌkoːdi
kutsuntaikä	ˈkutsuntɑˌikæ
kutsuvieras	ˈkutsuˌʋie̯rɑs
kutupuku	ˈkutuˌpuku
kuudenlainen	ˈkuːdenlɑi̯nen
kuuhulluus	ˈkuːˌhulːuːs
kuukausimansikka	ˈkuːˌkɑu̯siˌmɑnsikːɑ
kuukausivuokra	ˈkuːˌkɑu̯siˌʋuo̯krɑ
kuukuna	ˈkuːkunɑ
kuulakynä	ˈkuːlɑˌkynæ
kuulemattomuus	ˈkuːlemɑtːomuːs
kuulla	ˈkuːlːɑˣ
kuulohallusinaatio	ˈkuːloˌhɑlːusinɑːtio
kuulokyky	ˈkuːloˌkyky
kuulontarkastus	ˈkuːlonˌtɑrkɑstus
kuulovammaisuus	ˈkuːloˌʋɑmːɑi̯suːs
kuultokuva	ˈkuːltoˌkuʋɑ
kuulumattomasti	ˈkuːlumɑtːomɑstiˣ
kuulustuttaa	ˈkuːlustutːɑːˣ
kuumahauraus	ˈkuːmɑˌhɑu̯rɑus
kuumalujuus	ˈkuːmɑˌlujuːs
kuumasavustus	ˈkuːmɑˌsɑʋustus
kuumaverisyys	ˈkuːmɑˌʋerisyːs
kuumeisesti	ˈkuːmei̯sestiˣ
kuumennusvastus	ˈkuːmenːusˌʋɑstus
kuumetautinen	ˈkuːmeˣˌtɑu̯tinen
kuunaamainen	ˈkuːˌnɑːmɑi̯nen
kuunnella	ˈkuːnːelːɑˣ
kuunvaihe	ˈkuːnˌʋɑi̯heˣ
kuurapartainen	ˈkuːrɑˌpɑrtɑi̯nen
kuuromykkyys	ˈkuːroˌmykːyːs
kuusennäre	ˈkuːsenˌnæreˣ
kuusikuitu	ˈkuːsiˌkui̯tu
kuusimetsä	ˈkuːsiˌmetsæ
kuusiokolo	ˈkuːsioˌkolo
kuusisylinterinen	ˈkuːsiˌsylinterinen
kuusivuotinen	ˈkuːsiˌʋuo̯tinen
kuutioittain	ˈkuːtioi̯tːɑi̯n
kuutiomitta	ˈkuːtioˌmitːɑ
kuva	ˈkuʋɑ
kuvaamattomasti	ˈkuʋɑːmɑtːomɑstiˣ
kuvaileminen	ˈkuʋɑi̯leminen
kuvajoukko	ˈkuʋɑˌjou̯kːo
kuvakoko	ˈkuʋɑˌkoko
kuvallinen	ˈkuʋɑlːinen
kuvankaunis	ˈkuʋɑnˌkɑu̯nis
kuvantaminen	ˈkuʋɑntɑminen
kuvapinta	ˈkuʋɑˌpintɑ
kuvasanaristikko	ˈkuʋɑˌsɑnɑˌristikːo
kuvastua	ˈkuʋɑstuɑˣ
kuvatallenne	ˈkuʋɑˌtɑlːenːeˣ
kuvatulkinta	ˈkuʋɑˌtulkintɑ
kuvaussihteeri	ˈkuʋɑusˌsihteːri
kuvio	ˈkuʋio
kuviomerkki	ˈkuʋioˌmerkːi
kuvitteellinen	ˈkuʋitːeːlːinen
kvadraattisesti	ˈkʋɑdrɑːtːisestiˣ
kvantittunut	ˈkʋɑntitːunut
kvanttisuhde	ˈkʋɑntːiˌsuhdeˣ
kvartetti	ˈkʋɑrtetːi
kvasikide	ˈkʋɑsiˌkideˣ
kvintiini	ˈkʋintiːni
kydöttäminen	ˈkydøtːæminen
kyhätä	ˈkyhætæˣ
kyljitysten	ˈkyljitysten
kylkipala	ˈkylkiˌpɑlɑ
kyllyys	ˈkylːyːs
kyllästymätön	ˈkylːæstymætøn
kyllästäminen	ˈkylːæstæminen
kylmetä	ˈkylmetæˣ
kylmähauraus	ˈkylmæˌhɑu̯rɑus
kylmäkassi	ˈkylmæˌkɑsːi
kylmälaite	ˈkylmæˌlɑi̯teˣ
kylmänkestävä	ˈkylmænˌkestæʋæ
kylmäpuristus	ˈkylmæˌpuristus
kylmäsydäminen	ˈkylmæˌsydæm(ː)inen
kylmävalssaus	ˈkylmæˌʋɑlsːɑus
kylpeä	ˈkylpeæˣ
kylpyläkaupunki	ˈkylpylæˌkɑu̯puŋki
kylväjä	ˈkylʋæjæ
kylvöpuuro	ˈkylʋøˌpuːro
kyly	ˈkyly
kyläkokous	ˈkylæˌkokous
kylänraitti	ˈkylænˌrɑi̯tːi
kylätappelu	ˈkylæˌtɑpːelu
kymmen	ˈkymːen
kymmenestuhannes	ˈkymːenesˌtuhɑnːes
kymmenlukuinen	ˈkymːenˌlukui̯nen
kymmentuntinen	ˈkymːenˌtuntinen
kymnasisti	ˈkymnɑsisti
kyniä	ˈkyniæˣ
kynnyspuu	ˈkynːysˌpuː
kynsihoitola	ˈkynsiˌhoi̯tolɑ
kynsinauha	ˈkynsiˌnɑu̯hɑ
kynttelikkö	ˈkyntːelikːø
kynttilänpoltto	ˈkyntːilænˌpoltːo
kyntöpelto	ˈkyntøˌpelto
kynäkirjoitus	ˈkynæˌkirjoi̯tus
kynäsota	ˈkynæˌsotɑ
kypsyttely	ˈkypsytːely
kypsänkeltainen	ˈkypsænˌkeltɑi̯nen
kyrpiintyä	ˈkyrpiːntyæˣ
kyräilijä	ˈkyræi̯lijæ
kyseistää	ˈkysei̯stæːˣ
kysta	ˈkystɑ
kysymyssana	ˈkysymysˌsɑnɑ
kyteminen	ˈkyteminen
kytkeä	ˈkytkeæˣ
kytkös	ˈkytkøs
kytätä	ˈkytætæˣ
kyyditys	ˈkyːditys
kyykkypaska	ˈkyːkːyˌpɑskɑ
kyykystä	ˈkyːkystæ
kyynelkaasupistooli	ˈkyːnelˌkɑːsuˌpistoːli
kyynelöityä	ˈkyːneløi̯tyæˣ
kyynärä	ˈkyːnæræ
kyyryhaikara	ˈkyːryˌhɑi̯kɑrɑ
kyyröttää	ˈkyːrøtːæːˣ
kyä	ˈkyæ
kädensuojus	ˈkædenˌsuo̯jus
kädetys	ˈkædetys
kähertyä	ˈkæhertyæˣ
kähveltää	ˈkæhʋeltæːˣ
kähärätukkainen	ˈkæhæræˌtukːɑi̯nen
käkätys	ˈkækætys
kälynen	ˈkælynen
kämmenmikro	ˈkæmːenˌmikro
kämmäys	ˈkæmːæys
känni	ˈkænːi
kännätä	ˈkænːætæˣ
käpistely	ˈkæpistely
käpy	ˈkæpy
käpypalmu	ˈkæpyˌpɑlmu
käreys	ˈkæreys
kärjekkyys	ˈkærjekːyːs
kärkevyys	ˈkærkeʋyːs
kärkijäsen	ˈkærkiˌjæsen
kärkinivel	ˈkærkiˌniʋel
kärkisorvi	ˈkærkiˌsorʋi
kärkkäri	ˈkærkːæri
kärpässarja	ˈkærpæsˌsɑrjɑ
kärrytä	ˈkærːytæˣ
kärsimättömyys	ˈkærsimætːømyːs
kärventyminen	ˈkærʋentyminen
kärytä	ˈkærytæˣ
käräjäkunta	ˈkæræjæˌkuntɑ
käräjäympyrä	ˈkæræjæˌympyræ
käsialantutkija	ˈkæsiˌɑlɑnˌtutkijɑ
käsiensuojain	ˈkæsienˌsuo̯jɑi̯n
käsikirjasto	ˈkæsiˌkirjɑsto
käsikopelolta	ˈkæsiˌkopeloltɑ
käsiliike	ˈkæsiˌliːkeˣ
käsinepari	ˈkæsineˣˌpɑri
käsinseisonta	ˈkæsinˌsei̯sontɑ
käsipeli	ˈkæsiˌpeli
käsipuu	ˈkæsiˌpuː
käsisyöttö	ˈkæsiˌsyø̯tːø
käsiteltävyys	ˈkæsiteltæʋyːs
käsitteellisesti	ˈkæsitːeːlːisestiˣ
käsittelypalvelu	ˈkæsitːelyˌpɑlʋelu
käsityksin	ˈkæsityksin
käsityökasvatus	ˈkæsiˌtyø̯ˌkɑsʋɑtus
käsityöneuvos	ˈkæsiˌtyø̯ˌneu̯ʋos
käsityötarvike	ˈkæsiˌtyø̯ˌtɑrʋikeˣ
käsivaralla	ˈkæsiˌʋɑrɑlːɑ
käsivarsinauha	ˈkæsiˌʋɑrsiˌnɑu̯hɑ
käsky	ˈkæsky
käskytys	ˈkæskytys
käteismyynti	ˈkætei̯sˌmyːnti
kätevästi	ˈkæteʋæstiˣ
kätkä	ˈkætkæ
kättä pitempi	ˈkætːæ ˈpitempi
kävelyetäisyys	ˈkæʋelyˌetæi̯syːs
kävelytapa	ˈkæʋelyˌtɑpɑ
käväistä	ˈkæʋæi̯stæˣ
käydä päinsä	ˈkæy̯dæˣ ˈpæi̯nsæˣ
käymätön	ˈkæy̯mætøn
käynnistysmoottori	ˈkæy̯nːistysˌmoːtːori
käyntiinpano	ˈkæy̯ntiːnˌpɑno
käyntitapa	ˈkæy̯ntiˌtɑpɑ
käyristymä	ˈkæy̯ristymæ
käyrätorvi	ˈkæy̯ræˌtorʋi
käyttäjä	ˈkæy̯tːæjæ
käyttäjätila	ˈkæy̯tːæjæˌtilɑ
käyttäytymisnormi	ˈkæy̯tːæy̯tymisˌnormi
käyttöakseli	ˈkæy̯tːøˌɑkseli
käyttöinsinööri	ˈkæy̯tːøˌinsinøːri
käyttölaite	ˈkæy̯tːøˌlɑi̯teˣ
käyttöohjekirja	ˈkæy̯tːøˌohjeˣˌkirjɑ
käyttötaide	ˈkæy̯tːøˌtɑi̯deˣ
käyttövalmis	ˈkæy̯tːøˌʋɑlmis
käytännöllinen	ˈkæy̯tænːølːinen
käytönvalvontajärjestelmä	ˈkæy̯tønˌʋɑlʋontɑˌjærjestelmæ
käämi	ˈkæːmi
käännynnäinen	ˈkæːnːynːæi̯nen
käännösaika	ˈkæːnːøsˌɑi̯kɑ
käännöstehtävä	ˈkæːnːøsˌtehtæʋæ
käänteisesti	ˈkæːntei̯sestiˣ
kääntely	ˈkæːntely
kääntäjä	ˈkæːntæjæ
kääntöpaikka	ˈkæːntøˌpɑi̯kːɑ
kääpiöityminen	ˈkæːpiøi̯tyminen
kääpiösarjalainen	ˈkæːpiøˌsɑrjɑlɑi̯nen
käärepaperi	ˈkæːreˣˌpɑperi
käärmeenpisto	ˈkæːrmeːnˌpisto
käärmenainen	ˈkæːrmeˣˌnɑi̯nen
köhittää	ˈkøhitːæːˣ
kölinlasku	ˈkølinˌlɑsku
kömmähtäminen	ˈkømːæhtæminen
könkkö	ˈkøŋkːø
köntystely	ˈkøntystely
körttipuku	ˈkørtːiˌpuku
köyhtyminen	ˈkøy̯htyminen
köyhälistökortteli	ˈkøy̯hælistøˌkortːeli
köynnös	ˈkøy̯nːøs
köyryinen	ˈkøy̯ryi̯nen
köysikela	ˈkøy̯siˌkelɑ
köyttäminen	ˈkøy̯tːæminen
laahaaminen	ˈlɑːhɑːminen
laahusnuotta	ˈlɑːhusˌnuo̯tːɑ
laajakantoinen	ˈlɑːjɑˌkɑntoi̯nen
laajanäkemyksinen	ˈlɑːjɑˌnækemyksinen
laajaulotteinen	ˈlɑːjɑˌulotːei̯nen
laajennus	ˈlɑːjenːus
laakafilmikamera	ˈlɑːkɑˌfilmiˌkɑmerɑ
laakapallo	ˈlɑːkɑˌpɑlːo
laakavarsi	ˈlɑːkɑˌʋɑrsi
laakerinmarja	ˈlɑːkerinˌmɑrjɑ
laapiskivi	ˈlɑːpisˌkiʋi
laastipinta	ˈlɑːstiˌpintɑ
laatikkoonkanto	ˈlɑːtikːoːnˌkɑnto
laattakirja	ˈlɑːtːɑˌkirjɑ
laatuinen	ˈlɑːtui̯nen
laatuluokitus	ˈlɑːtuˌluo̯kitus
laatutaso	ˈlɑːtuˌtɑso
laatuvaatimus	ˈlɑːtuˌʋɑːtimus
labiilius	ˈlɑbiːlius
laboratoriolääketiede	ˈlɑborɑtorioˌlæːkeˣˌtie̯deˣ
ladata	ˈlɑdɑtɑˣ
lahdenpohja	ˈlɑhdenˌpohjɑ
lahjananto	ˈlɑhjɑnˌɑnto
lahjavarat	ˈlɑhjɑˌʋɑrɑt
lahjoma	ˈlɑhjomɑ
lahoamistila	ˈlɑhoɑmisˌtilɑ
lahota	ˈlɑhotɑˣ
lahtaus	ˈlɑhtɑus
laidemmalle	ˈlɑi̯demːɑlːeˣ
laidunkausi	ˈlɑi̯dunˌkɑu̯si
laiha	ˈlɑi̯hɑ
laihennus	ˈlɑi̯henːus
laika	ˈlɑi̯kɑ
laimenne	ˈlɑi̯menːeˣ
laina-anomus	ˈlɑi̯nɑˌ(ʔ)ɑnomus
lainakirjasto	ˈlɑi̯nɑˌkirjɑsto
lainasopimus	ˈlɑi̯nɑˌsopimus
laineittaa	ˈlɑi̯nei̯tːɑːˣ
laini	ˈlɑi̯ni
lainomainen	ˈlɑi̯nˌomɑi̯nen
lainsäädäntöneuvos	ˈlɑi̯nˌsæːdæntøˌneu̯ʋos
lainvalvoja	ˈlɑi̯nˌʋɑlʋojɑ
laippa	ˈlɑi̯pːɑ
laiskanpäivä	ˈlɑi̯skɑnˌpæi̯ʋæ
laistaminen	ˈlɑi̯stɑminen
laitamyötäinen	ˈlɑi̯tɑˌmyø̯tæi̯nen
laitelmisto	ˈlɑi̯telmisto
laitos	ˈlɑi̯tos
laitosmuotoinen	ˈlɑi̯tosˌmuo̯toi̯nen
laittaa	ˈlɑi̯tːɑːˣ
laiturimaksu	ˈlɑi̯turiˌmɑksu
laivajuna	ˈlɑi̯ʋɑˌjunɑ
laivalippu	ˈlɑi̯ʋɑˌlipːu
laivamuonitus	ˈlɑi̯ʋɑˌmuo̯nitus
laivanselvitys	ˈlɑi̯ʋɑnˌselʋitys
laivasatama	ˈlɑi̯ʋɑˌsɑtɑmɑ
laivatokka	ˈlɑi̯ʋɑˌtokːɑ
laivavuoro	ˈlɑi̯ʋɑˌʋuo̯ro
lajienvälinen	ˈlɑjienˌʋælinen
lajiristeymä	ˈlɑjiˌristey̯mæ
lajittelulaite	ˈlɑjitːeluˌlɑi̯teˣ
lakaisukone	ˈlɑkɑi̯suˌkoneˣ
lakea	ˈlɑkeɑ
lakiasia	ˈlɑkiˌɑsiɑ
lakimuutos	ˈlɑkiˌmuːtos
lakitiede	ˈlɑkiˌtie̯deˣ
lakkalikööri	ˈlɑkːɑˌlikøːri
lakkautus	ˈlɑkːɑu̯tus
lakkoileminen	ˈlɑkːoi̯leminen
lakkorintama	ˈlɑkːoˌrintɑmɑ
lakonalainen	ˈlɑkonˌɑlɑi̯nen
lakritsijäätelö	ˈlɑkritsiˌjæːtelø
laktaasientsyymi	ˈlɑktɑːsiˌentsyːmi
lamaannustila	ˈlɑmɑːnːusˌtilɑ
lambda	ˈlɑmbdɑ
laminaattilevy	ˈlɑminɑːtːiˌleʋy
lammaspaisti	ˈlɑmːɑsˌpɑi̯sti
lamoava	ˈlɑmoɑʋɑ
lampaannata	ˈlɑmpɑːnˌnɑtɑ
lampi	ˈlɑmpi
lampunjalka	ˈlɑmpunˌjɑlkɑ
lana	ˈlɑnɑ
langoittaa	ˈlɑŋːoi̯tːɑːˣ
lankalasi	ˈlɑŋkɑˌlɑsi
lankasilmukka	ˈlɑŋkɑˌsilmukːɑ
lankeaminen	ˈlɑŋkeɑminen
lankomies	ˈlɑŋkoˌmie̯s
lanne	ˈlɑnːeˣ
lannoite	ˈlɑnːoi̯teˣ
lanoliinipitoinen	ˈlɑnoliːniˌpitoi̯nen
lantakuoriainen	ˈlɑntɑˌkuo̯riɑi̯nen
lantavesikaivo	ˈlɑntɑˌʋesiˌkɑi̯ʋo
lantionseutu	ˈlɑntionˌseu̯tu
lanttuperhonen	ˈlɑntːuˌperhonen
lapakulma	ˈlɑpɑˌkulmɑ
lape	ˈlɑpeˣ
lapinkoira	ˈlɑpinˌkoi̯rɑ
lapinraunio	ˈlɑpinˌrɑu̯nio
lapiosarvi	ˈlɑpioˌsɑrʋi
lappalaispuku	ˈlɑpːɑlɑi̯sˌpuku
lappilaisuus	ˈlɑpːilɑi̯suːs
lapsenhoito	ˈlɑpsenˌhoi̯to
lapsenruokko	ˈlɑpsenˌruo̯kːo
lapsettaa	ˈlɑpsetːɑːˣ
lapsiavioliitto	ˈlɑpsiˌɑʋioˌliːtːo
lapsilukko	ˈlɑpsiˌlukːo
lapsiportti	ˈlɑpsiˌportːi
lapsirikollinen	ˈlɑpsiˌrikolːinen
lapsiystävällinen	ˈlɑpsiˌystæʋælːinen
lapsuusikä	ˈlɑpsuːsˌikæ
larpata	ˈlɑrpɑtɑˣ
lasagnelevy	ˈlɑsɑɡneˌleʋy
laserkeilain	ˈlɑ(ː)serˌkei̯lɑi̯n
lasertuloste	ˈlɑ(ː)serˌtulosteˣ
lasikannu	ˈlɑsiˌkɑnːu
lasikuitumuovi	ˈlɑsiˌkui̯tuˌmuo̯ʋi
lasikulho	ˈlɑsiˌkulho
lasinegatiivi	ˈlɑsiˌneɡɑtiːʋi
lasinpalanen	ˈlɑsinˌpɑlɑnen
lasirakenne	ˈlɑsiˌrɑkenːeˣ
lasisto	ˈlɑsisto
lasittua	ˈlɑsitːuɑˣ
lasiveistos	ˈlɑsiˌʋei̯stos
laskentamenetelmä	ˈlɑskentɑˌmenetelmæ
laskettelusuksi	ˈlɑsketːeluˌsuksi
laskimonlaajentuma	ˈlɑskimonˌlɑːjentumɑ
laskossauma	ˈlɑskosˌsɑu̯mɑ
laskujoki	ˈlɑskuˌjoki
laskukynnys	ˈlɑskuˌkynːys
laskutehtävä	ˈlɑskuˌtehtæʋæ
laskuvarjoneekeri	ˈlɑskuˌʋɑrjoˌneːkeri
lastauttaa	ˈlɑstɑutːɑːˣ
lastenkieli	ˈlɑstenˌkie̯li
lastenlaulu	ˈlɑstenˌlɑu̯lu
lastenperinne	ˈlɑstenˌperinːeˣ
lastensairaala	ˈlɑstenˌsɑi̯rɑːlɑ
lastenvaunut	ˈlɑstenˌʋɑu̯nut
lastoitus	ˈlɑstoi̯tus
lastuttavuus	ˈlɑstutːɑʋuːs
latauspiste	ˈlɑtɑusˌpisteˣ
lateraali	ˈlɑterɑːli
latinki	ˈlɑtiŋki
latomeri	ˈlɑtoˌmeri
lattaritanssi	ˈlɑtːɑriˌtɑnsːi
lattiakanava	ˈlɑtːiɑˌkɑnɑʋɑ
lattianalus	ˈlɑtːiɑnˌɑlus
lattianpäällystäjä	ˈlɑtːiɑnˌpæːlːystæjæ
lattiatäyte	ˈlɑtːiɑˌtæy̯teˣ
latukone	ˈlɑtuˌkoneˣ
latvakasvain	ˈlɑtʋɑˌkɑsʋɑi̯n
latvialainen	ˈlɑtʋiɑlɑi̯nen
lauantaipäivä	ˈlɑu̯ɑntɑi̯ˌpæi̯ʋæ
laudaturylioppilas	ˈlɑu̯dɑ(ː)t(ː)urˌyliˌopːilɑs
lauhdepumppu	ˈlɑu̯hdeˣˌpumpːu
lauhtuminen	ˈlɑu̯htuminen
laukaisuteline	ˈlɑu̯kɑi̯suˌtelineˣ
laukkaava	ˈlɑu̯kːɑːʋɑ
laukkukauppa	ˈlɑu̯kːuˌkɑu̯pːɑ
laulattaa	ˈlɑu̯lɑtːɑːˣ
laulukuoro	ˈlɑu̯luˌkuo̯ro
laulunopas	ˈlɑu̯lunˌopɑs
laulurunous	ˈlɑu̯luˌrunous
laulutaito	ˈlɑu̯luˌtɑi̯to
laumaihminen	ˈlɑu̯mɑˌihminen
lauseenlisäke	ˈlɑu̯seːnˌlisækeˣ
lausetyyppi	ˈlɑu̯seˣˌtyːpːi
lausuntakuoro	ˈlɑu̯suntɑˌkuo̯ro
lauta-aita	ˈlɑu̯tɑˌ(ʔ)ɑi̯tɑ
lautanauha	ˈlɑu̯tɑˌnɑu̯hɑ
lautasliinatekniikka	ˈlɑu̯tɑsˌliːnɑˌtekniːkːɑ
lauttaliikenne	ˈlɑu̯tːɑˌliːkenːeˣ
lava	ˈlɑʋɑ
lavantautiepidemia	ˈlɑʋɑnˌtɑu̯tiˌepidemiɑ
lavastustaide	ˈlɑʋɑstusˌtɑi̯deˣ
laveeraus	ˈlɑʋeːrɑus
laveta	ˈlɑʋetɑˣ
leasing	ˈliːsiŋː
ledinäyttö	ˈlediˌnæy̯tːø
legaatti	ˈleɡɑːtːi
lehahdella	ˈlehɑhdelːɑˣ
lehdistökirjoittelu	ˈlehdistøˌkirjoi̯tːelu
lehmipoika	ˈlehmiˌpoi̯kɑ
lehmänkauppa	ˈlehmænˌkɑu̯pːɑ
lehtevä	ˈlehteʋæ
lehtiharava	ˈlehtiˌhɑrɑʋɑ
lehtikirva	ˈlehtiˌkirʋɑ
lehtimaja	ˈlehtiˌmɑjɑ
lehtisarvinen	ˈlehtiˌsɑrʋinen
lehtitieto	ˈlehtiˌtie̯to
lehto	ˈlehto
lehvistö	ˈlehʋistø
leijonahäkki	ˈlei̯jonɑˌhækːi
leijonapaitainen	ˈlei̯jonɑˌpɑi̯tɑi̯nen
leikata	ˈlei̯kɑtɑˣ
leikillisyys	ˈlei̯kilːisyːs
leikinteko	ˈlei̯kinˌteko
leikkaushoito	ˈlei̯kːɑusˌhoi̯to
leikkauspinta	ˈlei̯kːɑusˌpintɑ
leikkelepöytä	ˈlei̯kːeleˣˌpøy̯tæ
leikkikaveri	ˈlei̯kːiˌkɑʋeri
leikkiperinne	ˈlei̯kːiˌperinːeˣ
leikkitoiminta	ˈlei̯kːiˌtoi̯mintɑ
leikkuu	ˈlei̯kːuː
leili	ˈlei̯li
leimahtaminen	ˈlei̯mɑhtɑminen
leimautua	ˈlei̯mɑu̯tuɑˣ
leipomohiiva	ˈlei̯pomoˌhiːʋɑ
leipähäkki	ˈlei̯pæˌhækːi
leipäpalanen	ˈlei̯pæˌpɑlɑnen
leipävanukas	ˈlei̯pæˌʋɑnukɑs
leirikoulu	ˈlei̯riˌkou̯lu
leiskahtaa	ˈlei̯skɑhtɑːˣ
leivinpöytä	ˈlei̯ʋinˌpøy̯tæ
leivos	ˈlei̯ʋos
leivänpalanen	ˈlei̯ʋænˌpɑlɑnen
lekottelu	ˈlekotːelu
lellikkipoika	ˈlelːikːiˌpoi̯kɑ
lemahdus	ˈlemɑhdus
lemmenjumala	ˈlemːenˌjumɑlɑ
lemmenlyriikka	ˈlemːenˌlyriːkːɑ
lemmenyö	ˈlemːenˌyø̯
lempiharrastus	ˈlempiˌhɑrːɑstus
lempiruoka	ˈlempiˌruo̯kɑ
lempääläinen	ˈlempæːlæi̯nen
lenkkeilyjalkine	ˈleŋkːei̯lyˌjɑlkineˣ
lenkko	ˈleŋkːo
lennonopettaja	ˈlenːonˌopetːɑjɑ
lennätinlaitos	ˈlenːætinˌlɑi̯tos
lentoambulanssi	ˈlentoˌɑmbulɑnsːi
lentokoneellinen	ˈlentoˌkoneːlːinen
lentokonetekniikka	ˈlentoˌkoneˣˌtekniːkːɑ
lentolannoitus	ˈlentoˌlɑnːoi̯tus
lentomekaanikko	ˈlentoˌmekɑːnikːo
lentopalloilija	ˈlentoˌpɑlːoi̯lijɑ
lentopäiväkirja	ˈlentoˌpæi̯ʋæˌkirjɑ
lentosuunta	ˈlentoˌsuːntɑ
lentotiedustelu	ˈlentoˌtie̯dustelu
lentovaneri	ˈlentoˌʋɑneri
lentää	ˈlentæːˣ
lepertely	ˈlepertely
lepoitiö	ˈlepoˌitiø
leposävel	ˈlepoˌsæʋel
leppoisuus	ˈlepːoi̯suːs
leptosomi	ˈleptosomi
lepytysuhri	ˈlepytysˌuhri
lerpalle	ˈlerpɑlːeˣ
lese	ˈleseˣ
lesoilla	ˈlesoi̯lːɑˣ
lesty	ˈlesty
letkauttaminen	ˈletkɑutːɑminen
lettipää	ˈletːiˌpæː
leuanalus	ˈleu̯ɑnˌɑlus
leuhkiminen	ˈleu̯hkiminen
leukaperä	ˈleu̯kɑˌperæ
leukotrieeni	ˈleu̯kotrieːni
leventyä	ˈleʋentyæˣ
leveähuulisarvikuono	ˈleʋeæˌhuːliˌsɑrʋiˌkuo̯no
leveäsarvinen	ˈleʋeæˌsɑrʋinen
levitoiminen	ˈleʋitoi̯minen
levollisesti	ˈleʋolːisestiˣ
levyke	ˈleʋykeˣ
levypyörä	ˈleʋyˌpyø̯ræ
levyttäminen	ˈleʋytːæminen
levähtäminen	ˈleʋæhtæminen
leväyttää	ˈleʋæytːæːˣ
liberaalipuolue	ˈliberɑːliˌpuo̯lueˣ
libertarismi	ˈlibertɑrismi
lidukki	ˈlidukːi
liehauttaa	ˈlie̯hɑutːɑːˣ
liejupohja	ˈlie̯juˌpohjɑ
liekkiviina	ˈlie̯kːiˌʋiːnɑ
liemikuppi	ˈlie̯miˌkupːi
lientyä	ˈlie̯ntyæˣ
liero	ˈlie̯ro
lieskauuni	ˈlie̯skɑˌuːni
lietemaa	ˈlie̯teˣˌmɑː
lietsonta	ˈlie̯tsontɑ
liettää	ˈlie̯tːæːˣ
lievittävä	ˈlie̯ʋitːæʋæ
lihahyytelö	ˈlihɑˌhyːtelø
lihakuutio	ˈlihɑˌkuːtio
lihamuhennos	ˈlihɑˌmuhenːos
lihantuotanto	ˈlihɑnˌtuo̯tɑnto
lihapitoisuus	ˈlihɑˌpitoi̯suːs
lihasheikkous	ˈlihɑsˌhei̯kːous
lihaskäämi	ˈlihɑsˌkæːmi
lihassairaus	ˈlihɑsˌsɑi̯rɑus
lihasäilyke	ˈlihɑˌsæi̯lykeˣ
lihavoida	ˈlihɑʋoi̯dɑˣ
lihotusruokinta	ˈlihotusˌruo̯kintɑ
liidättää	ˈliːdætːæːˣ
liikahtaa	ˈliːkɑhtɑːˣ
liikamäärä	ˈliːkɑˌmæːræ
liikatoiminta	ˈliːkɑˌtoi̯mintɑ
liikeapulainen	ˈliːkeˣˌɑpulɑi̯nen
liikehuoneisto	ˈliːkeˣˌhuo̯nei̯sto
liikekirjanpito	ˈliːkeˣˌkirjɑnˌpito
liikematkustaja	ˈliːkeˣˌmɑtkustɑjɑ
liikenneinsinööri	ˈliːkenːeˣˌinsinøːri
liikennekulttuuri	ˈliːkenːeˣˌkultːuːri
liikennemuoto	ˈliːkenːeˣˌmuo̯to
liikennepoliisi	ˈliːkenːeˣˌpoliːsi
liikennesuunnitelma	ˈliːkenːeˣˌsuːnːitelmɑ
liikennevalistus	ˈliːkenːeˣˌʋɑlistus
liikennöijä	ˈliːkenːøi̯jæ
liikenteenvalvontakamera	ˈliːkenteːnˌʋɑlʋontɑˌkɑmerɑ
liikesuhde	ˈliːkeˣˌsuhdeˣ
liiketila	ˈliːkeˣˌtilɑ
liiketuttava	ˈliːkeˣˌtutːɑʋɑ
liikka	ˈliːkːɑ
liikkeenluovutus	ˈliːkːeːnˌluo̯ʋutus
liikkuma-ala	ˈliːkːumɑˌ(ʔ)ɑlɑ
liikkuvainen	ˈliːkːuʋɑi̯nen
liikuntaeste	ˈliːkuntɑˌesteˣ
liikuntakykyinen	ˈliːkuntɑˌkykyi̯nen
liikuntaneuvonta	ˈliːkuntɑˌneu̯ʋontɑ
liikuntasauma	ˈliːkuntɑˌsɑu̯mɑ
liikuntatutkimus	ˈliːkuntɑˌtutkimus
liikuttavuus	ˈliːkutːɑʋuːs
liimakorva	ˈliːmɑˌkorʋɑ
liimapintainen	ˈliːmɑˌpintɑi̯nen
liimatahra	ˈliːmɑˌtɑhrɑ
liinaharjainen	ˈliːnɑˌhɑrjɑi̯nen
liioitteleminen	ˈliːoi̯tːeleminen
liippakivi	ˈliːpːɑˌkiʋi
liiskaantua	ˈliːskɑːntuɑˣ
liisteröityminen	ˈliːsterøi̯tyminen
liitolento	ˈliːtoˌlento
liitto	ˈliːtːo
liittotempus	ˈliːtːoˌtempus
liittymä	ˈliːtːymæ
liituraitainen	ˈliːtuˌrɑi̯tɑi̯nen
liitäntäjohto	ˈliːtæntæˌjohto
liivinmaalainen	ˈliːʋinˌmɑːlɑi̯nen
likaisesti	ˈlikɑi̯sestiˣ
likavaatteet	ˈlikɑˌʋɑːtːeːt
likelle	ˈlikelːeˣ
likentyminen	ˈlikentyminen
likimailta	ˈlikiˌmɑi̯ltɑ
likinäköinen	ˈlikiˌnækøi̯nen
liko	ˈliko
lilja	ˈliljɑ
limamato	ˈlimɑˌmɑto
limerikki	ˈlimerikːi
limitin	ˈlimitin
limonadi	ˈlimonɑ(ː)di
lindströminpihvi	ˈlindstrøminˌpihʋi
lingvisti	ˈliŋʋisti
linjakartta	ˈlinjɑˌkɑrtːɑ
linjanveto	ˈlinjɑnˌʋeto
linjatiheys	ˈlinjɑˌtiheys
linkkaaminen	ˈliŋkːɑːminen
linkkuveitsi	ˈliŋkːuˌʋei̯tsi
linnalääni	ˈlinːɑˌlæːni
linnanrouva	ˈlinːɑnˌrou̯ʋɑ
linnoitusjoukot	ˈlinːoi̯tusˌjou̯kot
linnunnokka	ˈlinːunˌnokːɑ
linnustaminen	ˈlinːustɑminen
linssijärjestelmä	ˈlinsːiˌjærjestelmæ
lintsaaminen	ˈlintsɑːminen
lintubongaus	ˈlintuˌboŋːɑus
lintulaskenta	ˈlintuˌlɑskentɑ
lintuvesi	ˈlintuˌʋesi
liotusaine	ˈliotusˌɑi̯neˣ
liperiläinen	ˈliperilæi̯nen
lipeäkivi	ˈlipeæˌkiʋi
liplatus	ˈliplɑtus
lippu	ˈlipːu
lipputervehdys	ˈlipːuˌterʋehdys
lipsaus	ˈlipsɑus
lipunlasku	ˈlipunˌlɑsku
lirahtaminen	ˈlirɑhtɑminen
liriä	ˈliriæˣ
lirunlaru	ˈlirunlɑru
lisensointi	ˈlisensoi̯nti
listamerkki	ˈlistɑˌmerkːi
listoittaa	ˈlistoi̯tːɑːˣ
lisäelämä	ˈlisæˌelæmæ
lisäjuna	ˈlisæˌjunɑ
lisäkulut	ˈlisæˌkulut
lisämenoarvio	ˈlisæˌmenoˌɑrʋio
lisäruokinta	ˈlisæˌruo̯kintɑ
lisätä	ˈlisætæˣ
lisää	ˈlisæː
lisääntymättömyys	ˈlisæːntymætːømyːs
litistyksissä	ˈlitistyksisːæ
litosfäärilaatta	ˈlitoˌsfæːriˌlɑːtːɑ
litsiluumu	ˈlitsiˌluːmu
litu	ˈlitu
liuentaa	ˈliu̯entɑːˣ
liukastua	ˈliu̯kɑstuɑˣ
liukoisuus	ˈliu̯koi̯suːs
liukukerros	ˈliu̯kuˌkerːos
liukuminen	ˈliu̯kuminen
liukusäädin	ˈliu̯kuˌsæːdin
liuota	ˈliu̯otɑˣ
liuska	ˈliu̯skɑ
liu’uttaa	ˈliu̯.utːɑːˣ
liveroolipeli	ˈliʋeˌroːliˌpeli
liveäänitys	ˈliʋeˌæːnitys
lobbaaminen	ˈlobːɑːminen
lognormaalinen	ˈloɡ.normɑːlinen
lohduttomuus	ˈlohdutːomuːs
lohestus	ˈlohestus
lohilammikko	ˈlohiˌlɑmːikːo
lohivoileipä	ˈlohiˌʋoi̯ˌlei̯pæ
lohkeaminen	ˈlohkeɑminen
lohkoittain	ˈlohkoi̯tːɑi̯n
lohkovuoristo	ˈlohkoˌʋuo̯risto
loikkiminen	ˈloi̯kːiminen
loimi	ˈloi̯mi
loinen	ˈloi̯nen
loisio	ˈloi̯sio
loiskutus	ˈloi̯skutus
loistava	ˈloi̯stɑʋɑ
loistevalaisin	ˈloi̯steˣˌʋɑlɑi̯sin
loistokuntoinen	ˈloi̯stˌokuntoi̯nen
loito	ˈloi̯to
loitsinta	ˈloi̯tsintɑ
loiventua	ˈloi̯ʋentuɑˣ
lokaalisesti	ˈlokɑːlisestiˣ
lokero	ˈlokero
lokirivi	ˈlokiˌriʋi
loksahdus	ˈloksɑhdus
loma-asutus	ˈlomɑˌ(ʔ)ɑsutus
lomakuu	ˈlomɑˌkuː
lomanviettopaikka	ˈlomɑnˌʋie̯tːoˌpɑi̯kːɑ
lomarakentaminen	ˈlomɑˌrɑkentɑminen
lomauttaminen	ˈlomɑutːɑminen
lomitusten	ˈlomitusten
lonkero	ˈloŋkero
lonksuttaa	ˈloŋksutːɑːˣ
loparit	ˈlopɑrit
loppelainen	ˈlopːelɑi̯nen
loppuerä	ˈlopːuˌeræ
loppukerto	ˈlopːuˌkerto
loppulausunto	ˈlopːuˌlɑu̯sunto
loppunumero	ˈlopːuˌnumero
loppurepeämä	ˈlopːuˌrepeæmæ
loppusijoituspaikka	ˈlopːuˌsijoi̯tusˌpɑi̯kːɑ
lopputaival	ˈlopːuˌtɑi̯ʋɑl
lopputoimi	ˈlopːuˌtoi̯mi
loppuviimein	ˈlopːuˌʋiːmei̯n
lorahtaa	ˈlorɑhtɑːˣ
loru	ˈloru
lorvi	ˈlorʋi
lossiyhteys	ˈlosːiˌyhteys
lottoaminen	ˈlotːoɑminen
louhe	ˈlou̯heˣ
loukata	ˈlou̯kɑtɑˣ
loukkaus	ˈlou̯kːɑus
lounaismyrsky	ˈlou̯nɑi̯sˌmyrsky
lounastaminen	ˈlou̯nɑstɑminen
lovi	ˈloʋi
lude	ˈludeˣ
luentokurssi	ˈluentoˌkursːi
lueskeleminen	ˈlueskeleminen
luetteloija	ˈluetːeloi̯jɑ
luettelomerkki	ˈluetːeloˌmerkːi
luhistuminen	ˈluhistuminen
luhti	ˈluhti
luikerteleminen	ˈlui̯kerteleminen
luinen	ˈlui̯nen
luistattaa	ˈlui̯stɑtːɑːˣ
luistelusuksi	ˈlui̯steluˌsuksi
luja	ˈlujɑ
lujaluontoinen	ˈlujɑˌluo̯ntoi̯nen
lujentuminen	ˈlujentuminen
lujittuminen	ˈlujitːuminen
lukaista	ˈlukɑi̯stɑˣ
lukeutuminen	ˈlukeu̯tuminen
lukio	ˈlukio
lukitusjousi	ˈlukitusˌjou̯si
lukkaroida	ˈlukːɑroi̯dɑˣ
lukkoliitos	ˈlukːoˌliːtos
luksusasunto	ˈluksusˌɑsunto
lukukinkerit	ˈlukuˌkiŋkerit
lukumääräisesti	ˈlukuˌmæːræi̯sestiˣ
lukusana	ˈlukuˌsɑnɑ
lukutapa	ˈlukuˌtɑpɑ
lukuvirhe	ˈlukuˌʋirheˣ
lumenajo	ˈlumenˌɑjo
lumeta	ˈlumetɑˣ
lumierä	ˈlumiˌeræ
lumikenkäily	ˈlumiˌkeŋkæi̯ly
lumilautailija	ˈlumiˌlɑu̯tɑi̯lijɑ
luminanssi	ˈluminɑnsːi
lumipyry	ˈlumiˌpyry
lumoava	ˈlumoɑʋɑ
lumpsauttaa	ˈlumpsɑutːɑːˣ
lunastusoikeus	ˈlunɑstusˌoi̯keus
lunnasvaatimus	ˈlunːɑsˌʋɑːtimus
luode	ˈluo̯deˣ
luokittaa	ˈluo̯kitːɑːˣ
luokituskaava	ˈluo̯kitusˌkɑːʋɑ
luokkaluku	ˈluo̯kːɑˌluku
luokkavastakohta	ˈluo̯kːɑˌʋɑstɑˌkohtɑ
luokse	ˈluo̯kseˣ
luolamies	ˈluo̯lɑˌmie̯s
luomiskausi	ˈluo̯misˌkɑu̯si
luomumaito	ˈluo̯muˌmɑi̯to
luonnetyyppi	ˈluo̯nːeˣˌtyːpːi
luonnonarvo	ˈluo̯nːonˌɑrʋo
luonnonihme	ˈluo̯nːonˌihmeˣ
luonnonkosmetiikka	ˈluo̯nːonˌkosmetiːkːɑ
luonnonlapsi	ˈluo̯nːonˌlɑpsi
luonnonmenetelmä	ˈluo̯nːonˌmenetelmæ
luonnonoppi	ˈluo̯nːonˌopːi
luonnonsatama	ˈluo̯nːonˌsɑtɑmɑ
luonnonsuojeluohjelma	ˈluo̯nːonˌsuo̯jeluˌohjelmɑ
luonnontuote	ˈluo̯nːonˌtuo̯teˣ
luonnonväri	ˈluo̯nːonˌʋæri
luonnotar	ˈluo̯nːotɑr
luontaishoitola	ˈluo̯ntɑi̯sˌhoi̯tolɑ
luontaisviljely	ˈluo̯ntɑi̯sˌʋiljely
luonteisesti	ˈluo̯ntei̯sestiˣ
luontoemo	ˈluo̯ntoˌemo
luontokohde	ˈluo̯ntoˌkohdeˣ
luontoperäinen	ˈluo̯ntoˌperæi̯nen
luopuja	ˈluo̯pujɑ
luostarijärjestö	ˈluo̯stɑriˌjærjestø
luotaaminen	ˈluo̯tɑːminen
luotettavuusanalyysi	ˈluo̯tetːɑʋuːsˌɑnɑlyːsi
luotokirvinen	ˈluo̯toˌkirʋinen
luotottaja	ˈluo̯totːɑjɑ
luottaa	ˈluo̯tːɑːˣ
luottamuskysymys	ˈluo̯tːɑmusˌkysymys
luottavuus	ˈluo̯tːɑʋuːs
luottokorttipetos	ˈluo̯tːoˌkortːiˌpetos
luottovanki	ˈluo̯tːoˌʋɑŋki
luovutusmääräys	ˈluo̯ʋutusˌmæːræys
lupaileminen	ˈlupɑi̯leminen
lupauksenrikkoja	ˈlupɑuksenˌrikːojɑ
lupsahtaa	ˈlupsɑhtɑːˣ
lurittaa	ˈluritːɑːˣ
lurkkaaja	ˈlurkːɑːjɑ
lusikanvarsi	ˈlusikɑnˌʋɑrsi
lustosavi	ˈlustoˌsɑʋi
luu	ˈluː
luukalvo	ˈluːˌkɑlʋo
luukuttaa	ˈluːkutːɑːˣ
luulotautinen	ˈluːloˌtɑu̯tinen
luumukräämi	ˈluːmuˌkræːmi
luunkova	ˈluːnˌkoʋɑ
luura	ˈluːrɑ
luusto	ˈluːsto
luuton	ˈluːton
luutuminen	ˈluːtuminen
luuydinontelo	ˈluːˌydinˌontelo
luvialainen	ˈluʋiɑlɑi̯nen
lyhenemä	ˈlyhenemæ
lyhentymä	ˈlyhentymæ
lyhykäisyys	ˈlyhykæi̯syːs
lyhytaaltovastaanotin	ˈlyhytˌɑːltoˌʋɑstɑːnˌotin
lyhytjänteisyys	ˈlyhytˌjæntei̯syːs
lyhytohjelma	ˈlyhytˌohjelmɑ
lyhyttavara	ˈlyhytˌtɑʋɑrɑ
lyhyysmerkki	ˈlyhyːsˌmerkːi
lyijylasi	ˈlyi̯jyˌlɑsi
lyijypäällyste	ˈlyi̯jyˌpæːlːysteˣ
lykästää	ˈlykæstæːˣ
lymfaterapia	ˈlymfɑˌterɑpiɑ
lyonilainen	ˈlyonilɑi̯nen
lypsysanko	ˈlypsyˌsɑŋko
lysoli	ˈlysoli
lysähtää	ˈlysæhtæːˣ
lyöntivuoro	ˈlyø̯ntiˌʋuo̯ro
lähdeaines	ˈlæhdeˣˌɑi̯nes
lähdesuoja	ˈlæhdeˣˌsuo̯jɑ
läheisneuvonpito	ˈlæhei̯sˌneu̯ʋonˌpito
läheneminen	ˈlæheneminen
lähestymislaite	ˈlæhestymisˌlɑi̯teˣ
lähetinasema	ˈlæhetinˌɑsemɑ
lähettää	ˈlæhetːæːˣ
lähetyslista	ˈlæhetysˌlistɑ
lähetystöneuvos	ˈlæhetystøˌneu̯ʋos
lähidemokratia	ˈlæhiˌdemokrɑtiɑ
lähilasit	ˈlæhiˌlɑsit
lähimain	ˈlæhiˌmɑi̯n
lähin	ˈlæhin
lähiradio	ˈlæhiˌrɑdio
lähitelevisio	ˈlæhiˌteleʋisio
lähiökirjasto	ˈlæhiøˌkirjɑsto
lähtiäiset	ˈlæhtiæi̯set
lähtöjärjestys	ˈlæhtøˌjærjestys
lähtölupa	ˈlæhtøˌlupɑ
lähtöteho	ˈlæhtøˌteho
läikkäinen	ˈlæi̯kːæi̯nen
läimähtäminen	ˈlæi̯mæhtæminen
läiskyttää	ˈlæi̯skytːæːˣ
läiskäyttää	ˈlæi̯skæytːæːˣ
läjäyttää	ˈlæjæytːæːˣ
läksy	ˈlæksy
läkähtyminen	ˈlækæhtyminen
lämminhenkinen	ˈlæmːinˌheŋkinen
lämminverilähtö	ˈlæmːinˌʋeriˌlæhtø
lämmitys	ˈlæmːitys
lämmitysmuoto	ˈlæmːitysˌmuo̯to
lämmitysvoimalaitos	ˈlæmːitysˌʋoi̯mɑˌlɑi̯tos
lämmönlähde	ˈlæmːønˌlæhdeˣ
lämmönvaihtelu	ˈlæmːønˌʋɑi̯htelu
lämpimänpunainen	ˈlæmpimænˌpunɑi̯nen
lämpöeristää	ˈlæmpøˌeristæːˣ
lämpöily	ˈlæmpøi̯ly
lämpökiharrin	ˈlæmpøˌkihɑrːin
lämpölasi	ˈlæmpøˌlɑsi
lämpöpuku	ˈlæmpøˌpuku
lämpötalous	ˈlæmpøˌtɑlous
lämpövastus	ˈlæmpøˌʋɑstus
länkiharppi	ˈlæŋkiˌhɑrpːi
lännenloikkahiiri	ˈlænːenˌloi̯kːɑˌhiːri
länsimainen	ˈlænsiˌmɑi̯nen
länsipuolinen	ˈlænsiˌpuo̯linen
länsisuomalainen	ˈlænsiˌsuo̯mɑlɑi̯nen
läntällään	ˈlæntælːæːn
läpikuultavuus	ˈlæpiˌkuːltɑʋuːs
läpimittainen	ˈlæpiˌmitːɑi̯nen
läpisahaus	ˈlæpiˌsɑhɑus
läpivientiaukko	ˈlæpiˌʋie̯ntiˌɑu̯kːo
läpsytellä	ˈlæpsytelːæˣ
läpsäyttää	ˈlæpsæytːæːˣ
läpäisevä	ˈlæpæi̯seʋæ
läpättäminen	ˈlæpætːæminen
läskinen	ˈlæskinen
lästimaksu	ˈlæstiˌmɑksu
lätkäyttää	ˈlætkæytːæːˣ
lättänenä	ˈlætːæˌnenæ
lävistäminen	ˈlæʋistæminen
lääke-etiketti	ˈlæːkeˣˌetiketːi
lääkehoito	ˈlæːkeˣˌhoi̯to
lääkekuuri	ˈlæːkeˣˌkuːri
lääkerikos	ˈlæːkeˣˌrikos
lääketarjotin	ˈlæːkeˣˌtɑrjotin
lääketurvallisuus	ˈlæːkeˣˌturʋɑlːisuːs
lääkintähenkilöstö	ˈlæːkintæˌheŋkiløstø
lääkintävoimistelu	ˈlæːkintæˌʋoi̯mistelu
lääkäri	ˈlæːkæri
lääkärinkoulutus	ˈlæːkærinˌkou̯lutus
lääkäripula	ˈlæːkæriˌpulɑ
lääninkirjailija	ˈlæːninˌkirjɑi̯lijɑ
läänityslaitos	ˈlæːnitysˌlɑi̯tos
löllingiitti	ˈlølːiŋːiːtːi
lössähtää	ˈløsːæhtæːˣ
löylyttää	ˈløy̯lytːæːˣ
löytyminen	ˈløy̯tyminen
m	ˈæm
maa-artisokka	ˈmɑːˌɑrtisokːɑ
maaekosysteemi	ˈmɑːˌekoˌsysteːmi
maahanmuutto	ˈmɑːhɑnˌmuːtːo
maahantunkeutuja	ˈmɑːhɑnˌtuŋkeu̯tujɑ
maailmancup	ˈmɑːilmɑnˌkɑp
maailmanjärjestys	ˈmɑːilmɑnˌjærjestys
maailmankirja	ˈmɑːilmɑnˌkirjɑ
maailmanloppu	ˈmɑːilmɑnˌlopːu
maailmanmies	ˈmɑːilmɑnˌmie̯s
maailmanpolitiikka	ˈmɑːilmɑnˌpolitiːkːɑ
maailmanvalloitus	ˈmɑːilmɑnˌʋɑlːoi̯tus
maajoukkuepelaaja	ˈmɑːˌjou̯kːueˌpelɑːjɑ
maakari	ˈmɑːkɑri
maakohtainen	ˈmɑːˌkohtɑi̯nen
maakuntahenki	ˈmɑːˌkuntɑˌheŋki
maakuntakokous	ˈmɑːˌkuntɑˌkokous
maakuntamuseo	ˈmɑːˌkuntɑˌmuseo
maakuva	ˈmɑːˌkuʋɑ
maalaisjuusto	ˈmɑːlɑi̯sˌjuːsto
maalaistyttö	ˈmɑːlɑi̯sˌtytːø
maalausala	ˈmɑːlɑusˌɑlɑ
maalaustela	ˈmɑːlɑusˌtelɑ
maaliahne	ˈmɑːliˌɑhneˣ
maalikehikko	ˈmɑːliˌkehikːo
maalinedustapeli	ˈmɑːlinˌedustɑˌpeli
maalipurkki	ˈmɑːliˌpurkːi
maalitehtailija	ˈmɑːliˌtehtɑi̯lijɑ
maalitus	ˈmɑːlitus
maallikkonimi	ˈmɑːlːikːoˌnimi
maaltapako	ˈmɑːltɑˌpɑko
maamieskoulu	ˈmɑːˌmie̯sˌkou̯lu
maanantaisin	ˈmɑːnɑntɑi̯sin
maanisä	ˈmɑːnˌisæ
maankolkka	ˈmɑːnˌkolkːɑ
maanmittaushallinto	ˈmɑːnˌmitːɑusˌhɑlːinto
maannostuminen	ˈmɑːnːostuminen
maanparannus	ˈmɑːnˌpɑrɑnːus
maanpuolustaja	ˈmɑːnˌpuo̯lustɑjɑ
maanpuolustusvelvollisuus	ˈmɑːnˌpuo̯lustusˌʋelʋolːisuːs
maansäteily	ˈmɑːnˌsætei̯ly
maantienoja	ˈmɑːnˌtie̯nˌojɑ
maanuoliainen	ˈmɑːˌnuo̯liɑi̯nen
maanviljelyskemia	ˈmɑːnˌʋiljelysˌkemiɑ
maanvuokra	ˈmɑːnˌʋuo̯krɑ
maaomistus	ˈmɑːˌomistus
maapaikka	ˈmɑːˌpɑi̯kːɑ
maaperäfysiikka	ˈmɑːˌperæˌfysiːkːɑ
maapolitiikka	ˈmɑːˌpolitiːkːɑ
maarakennusliike	ˈmɑːˌrɑkenːusˌliːkeˣ
maaseutukiertue	ˈmɑːˌseu̯tuˌkie̯rtueˣ
maaseutusosiologia	ˈmɑːˌseu̯tuˌsosioloɡiɑ
maassaolo-oikeus	ˈmɑːsːɑˌoloˌ(ʔ)oi̯keus
maastoesteratsastus	ˈmɑːstoˌesteˣˌrɑtsɑstus
maastoliikenne	ˈmɑːstoˌliːkenːeˣ
maasulku	ˈmɑːˌsulku
maatalous	ˈmɑːˌtɑlous
maatalouskerho	ˈmɑːˌtɑlousˌkerho
maatalousministeriö	ˈmɑːˌtɑlousˌministeriø
maataloustekniikka	ˈmɑːˌtɑlousˌtekniːkːɑ
maataloustyö	ˈmɑːˌtɑlousˌtyø̯
maatapano	ˈmɑːtɑˣˌpɑno
maatiaisrotuinen	ˈmɑːtiɑi̯sˌrotui̯nen
maatilatalous	ˈmɑːˌtilɑˌtɑlous
maatuma	ˈmɑːtumɑ
maatyömies	ˈmɑːˌtyø̯ˌmie̯s
maayhteys	ˈmɑːˌyhteys
made	ˈmɑdeˣ
mafinen	ˈmɑfinen
magneettihoito	ˈmɑŋneːtːiˌhoi̯to
magneettineula	ˈmɑŋneːtːiˌneu̯lɑ
magneetto	ˈmɑŋneːtːo
maha-suolikanava	ˈmɑhɑˌsuo̯liˌkɑnɑʋɑ
mahanesterauhanen	ˈmɑhɑˌnesteˣˌrɑu̯hɑnen
mahatulehdus	ˈmɑhɑˌtulehdus
mahduttaminen	ˈmɑhdutːɑminen
mahonkinen	ˈmɑhoŋkinen
mahtava	ˈmɑhtɑʋɑ
mahtitekijä	ˈmɑhtiˌtekijæ
maidontarkastamo	ˈmɑi̯donˌtɑrkɑstɑmo
maihinnousuportaat	ˈmɑi̯hinˌnou̯suˌportɑːt
maila	ˈmɑi̯lɑ
maineikkaasti	ˈmɑi̯nei̯kːɑːstiˣ
mainittava	ˈmɑi̯nitːɑʋɑ
mainosgraafikko	ˈmɑi̯nosˌɡrɑːfikːo
mainoslahja	ˈmɑi̯nosˌlɑhjɑ
mainospäällikkö	ˈmɑi̯nosˌpæːlːikːø
mainostus	ˈmɑi̯nostus
mairittelu	ˈmɑi̯ritːelu
maisemanhoito	ˈmɑi̯semɑnˌhoi̯to
maiskutella	ˈmɑi̯skutelːɑˣ
maissipelto	ˈmɑi̯sːiˌpelto
maisterinseppele	ˈmɑi̯sterinˌsepːeleˣ
maite	ˈmɑi̯teˣ
maitohappokäyminen	ˈmɑi̯toˌhɑpːoˌkæy̯minen
maitokalkki	ˈmɑi̯toˌkɑlkːi
maitolaituri	ˈmɑi̯toˌlɑi̯turi
maitorahka	ˈmɑi̯toˌrɑhkɑ
maitoteknologia	ˈmɑi̯toˌteknoloɡiɑ
maitovalmiste	ˈmɑi̯toˌʋɑlmisteˣ
majakka-alus	ˈmɑjɑkːɑˌ(ʔ)ɑlus
majesteettius	ˈmɑjesteːtːius
majoituspalvelu	ˈmɑjoi̯tusˌpɑlʋelu
makaroni	ˈmɑkɑro(ː)ni
makeissekoitus	ˈmɑkei̯sˌsekoi̯tus
makia	ˈmɑkiɑ
makkarapata	ˈmɑkːɑrɑˌpɑtɑ
makromolekyylikemia	ˈmɑkroˌmolekyːliˌkemiɑ
maksamakkara	ˈmɑksɑˌmɑkːɑrɑ
maksaruohokasvi	ˈmɑksɑˌruo̯hoˌkɑsʋi
maksihame	ˈmɑksiˌhɑmeˣ
maksimilämpötila	ˈmɑksimiˌlæmpøˌtilɑ
maksuhäiriömerkintä	ˈmɑksuˌhæi̯riøˌmerkintæ
maksukyvyttömyysoikeus	ˈmɑksuˌkyʋytːømyːsˌoi̯keus
maksuperuste	ˈmɑksuˌperusteˣ
maksuttomuus	ˈmɑksutːomuːs
makuaistimus	ˈmɑkuˌɑi̯stimus
makusiirappi	ˈmɑkuˌsiːrɑpːi
makuulaveri	ˈmɑkuːˌlɑʋeri
makuvirhe	ˈmɑkuˌʋirheˣ
maleksinta	ˈmɑleksintɑ
maljapuhe	ˈmɑljɑˌpuheˣ
mallastaminen	ˈmɑlːɑstɑminen
mallikirjain	ˈmɑlːiˌkirjɑi̯n
mallinrakentaja	ˈmɑlːinˌrɑkentɑjɑ
mallisuojattu	ˈmɑlːiˌsuo̯jɑtːu
malmi	ˈmɑlmi
malmikivi	ˈmɑlmiˌkiʋi
malmio	ˈmɑlmio
malttaa	ˈmɑltːɑːˣ
mammalogia	ˈmɑmːɑloɡiɑ
mamselli	ˈmɑmselːi
mandaattialue	ˈmɑndɑːtːiˌɑlueˣ
maneerimaisesti	ˈmɑneːrimɑi̯sestiˣ
mangolassi	ˈmɑŋːoˌlɑsːi
manifestoituminen	ˈmɑnifestoi̯tuminen
mankka	ˈmɑŋkːɑ
manne	ˈmɑnːe
mannerlaatta	ˈmɑnːerˌlɑːtːɑ
mansikanpoimija	ˈmɑnsikɑnˌpoi̯mijɑ
mansikkamaa	ˈmɑnsikːɑˌmɑː
mansinkielinen	ˈmɑnsinˌkie̯linen
mantere	ˈmɑntereˣ
manumissio	ˈmɑnuˌmisːio
marenkikakku	ˈmɑreŋkiˌkɑkːu
margariinirasia	ˈmɑrɡɑriːniˌrɑsiɑ
marinadi	ˈmɑrinɑdi
marja	ˈmɑrjɑ
marjametsä	ˈmɑrjɑˌmetsæ
marjapuuronpunainen	ˈmɑrjɑˌpuːronˌpunɑi̯nen
marjavuosi	ˈmɑrjɑˌʋuo̯si
markiisitar	ˈmɑrkiːsitɑr
markkinaehtoinen	ˈmɑrkːinɑˌehtoi̯nen
markkinakorko	ˈmɑrkːinɑˌkorko
markkinatalousmaa	ˈmɑrkːinɑˌtɑlousˌmɑː
markkinointisihteeri	ˈmɑrkːinoi̯ntiˌsihteːri
marksismi-leninismi	ˈmɑrksismiˌleninismi
marmori	ˈmɑrmori
marmoroida	ˈmɑrmoroi̯dɑˣ
marraskesi	ˈmɑrːɑsˌkesi
marsipaanikakku	ˈmɑrsipɑːniˌkɑkːu
marssirivistö	ˈmɑrsːiˌriʋistø
maruna	ˈmɑrunɑ
masennus	ˈmɑsenːus
masentunut	ˈmɑsentunut
maski	ˈmɑski
masokisti	ˈmɑsokisti
massakommunikaatio	ˈmɑsːɑˌkomːunikɑːtio
massapsykologia	ˈmɑsːɑˌpsykoloɡiɑ
massatuote	ˈmɑsːɑˌtuo̯teˣ
massiivi	ˈmɑsːiːʋi
masto	ˈmɑsto
masuunikuona	ˈmɑsuːniˌkuo̯nɑ
matalajännite	ˈmɑtɑlɑˌjænːiteˣ
matalalento	ˈmɑtɑlɑˌlento
matalapaineinen	ˈmɑtɑlɑˌpɑi̯nei̯nen
matalatehoinen	ˈmɑtɑlɑˌtehoi̯nen
matchata	ˈmætsætæˣ
matematiikka	ˈmɑtemɑtiːkːɑ
materiaalitaistelu	ˈmɑteriɑːliˌtɑi̯stelu
materialistinen	ˈmɑteriɑlistinen
matka-arkku	ˈmɑtkɑˌ(ʔ)ɑrkːu
matkailuasiamies	ˈmɑtkɑi̯luˌɑsiɑˌmie̯s
matkailullisesti	ˈmɑtkɑi̯lulːisestiˣ
matkailutase	ˈmɑtkɑi̯luˌtɑseˣ
matkakirjoituskone	ˈmɑtkɑˌkirjoi̯tusˌkoneˣ
matkakuvaus	ˈmɑtkɑˌkuʋɑus
matkalukeminen	ˈmɑtkɑˌlukeminen
matkapapisto	ˈmɑtkɑˌpɑpisto
matkapurjevene	ˈmɑtkɑˌpurjeˣˌʋeneˣ
matkastipendi	ˈmɑtkɑˌstipendi
matkatyö	ˈmɑtkɑˌtyø̯
matkaviestinverkko	ˈmɑtkɑˌʋie̯stinˌʋerkːo
matkustaja-alus	ˈmɑtkustɑjɑˌ(ʔ)ɑlus
matonkude	ˈmɑtonˌkudeˣ
matriisitulostin	ˈmɑtriːsiˌtulostin
mattaväri	ˈmɑtːɑˌʋæri
mattokutomo	ˈmɑtːoˌkutomo
maturiteetti	ˈmɑturiteːtːi
maustekastike	ˈmɑu̯steˣˌkɑstikeˣ
maustepurkki	ˈmɑu̯steˣˌpurkːi
maustuminen	ˈmɑu̯stuminen
mediaani	ˈmediɑːni
medikalisoitua	ˈmedikɑlisoi̯tuɑˣ
megabitti	ˈmeɡɑˌbitːi
mehevyys	ˈmeheʋyːs
mehiläisenpisto	ˈmehilæi̯senˌpisto
mehu	ˈmehu
mehukkuus	ˈmehukːuːs
mehustella	ˈmehustelːɑˣ
meijerituote	ˈmei̯jeriˌtuo̯teˣ
meikkivoide	ˈmei̯kːiˌʋoi̯deˣ
meisseli	ˈmei̯sːeli
mekastella	ˈmekɑstelːɑˣ
meksikonlokki	ˈmeksikonˌlokːi
meleeraus	ˈmeleːrɑus
mellakointi	ˈmelːɑkoi̯nti
meloa	ˈmeloɑˣ
melontakilpailu	ˈmelontɑˌkilpɑi̯lu
melualue	ˈmeluˌɑlueˣ
meluseinä	ˈmeluˌsei̯næ
menehtyminen	ˈmenehtyminen
menestyselokuva	ˈmenestysˌeloˌkuʋɑ
menettää	ˈmenetːæːˣ
menneenkesäinen	ˈmenːeːnˌkesæi̯nen
mennä kihloihin	ˈmenːæ ˈkihloi̯hinˣ
menomatka	ˈmenoˌmɑtkɑ
menševistinen	ˈmenʃeʋistinen
meppi	ˈmepːi
merenkulkuoppilaitos	ˈmerenˌkulkuˌopːiˌlɑi̯tos
merenrantakaupunki	ˈmerenˌrɑntɑˌkɑu̯puŋki
merenvihreä	ˈmerenˌʋihreæ
meriekologi	ˈmeriˌekoloɡi
merijärvinen	ˈmeriˌjærʋinen
merikerrostuma	ˈmeriˌkerːostumɑ
merimaali	ˈmeriˌmɑːli
merimiespappi	ˈmeriˌmie̯sˌpɑpːi
meripelastus	ˈmeriˌpelɑstus
merisara	ˈmeriˌsɑrɑ
meristeemi	ˈmeristeːmi
meritieteellinen	ˈmeriˌtie̯teːlːinen
merivakuutusyhtiö	ˈmeriˌʋɑkuːtusˌyhtiø
meriviitta	ˈmeriˌʋiːtːɑ
merkaptaani	ˈmerkɑptɑːni
merkinantolaite	ˈmerkinˌɑntoˌlɑi̯teˣ
merkitsin	ˈmerkitsin
merkitysmaailma	ˈmerkitysˌmɑːˌilmɑ
merkkausliina	ˈmerkːɑusˌliːnɑ
merkkiluku	ˈmerkːiˌluku
merkkitapaus	ˈmerkːiˌtɑpɑus
merkkiviiva	ˈmerkːiˌʋiːʋɑ
mesikasvi	ˈmesiˌkɑsʋi
mesofylli	ˈmesoˌfylːi
messihuoltaja	ˈmesːiˌhuo̯ltɑjɑ
messissä	ˈmesːisːæ
messuvieras	ˈmesːuˌʋie̯rɑs
mestarillinen	ˈmestɑrilːinen
mestaritar	ˈmestɑritɑr
mestauspaikka	ˈmestɑusˌpɑi̯kːɑ
metabolismi	ˈmetɑbolismi
metakryylihappo	ˈmetɑkryːliˌhɑpːo
metallijauhe	ˈmetɑlːiˌjɑu̯heˣ
metalliladonta	ˈmetɑlːiˌlɑdontɑ
metallinhohde	ˈmetɑlːinˌhohdeˣ
metallinkiiltävä	ˈmetɑlːinˌkiːltæʋæ
metallinvärjäys	ˈmetɑlːinˌʋærjæys
metallipöly	ˈmetɑlːiˌpøly
metallisuola	ˈmetɑlːiˌsuo̯lɑ
metalliväri	ˈmetɑlːiˌʋæri
metastasoiminen	ˈmetɑˌstɑsoi̯minen
meteoriparvi	ˈmeteoriˌpɑrʋi
metkuilla	ˈmetkui̯lːɑˣ
metodologia	ˈmetodoˌloɡiɑ
metristys	ˈmetristys
metrorata	ˈmetroˌrɑtɑ
metsä-äes	ˈmetsæˌ(ʔ)æes
metsäekosysteemi	ˈmetsæˌekoˌsysteːmi
metsäkasvillisuus	ˈmetsæˌkɑsʋilːisuːs
metsäkämppä	ˈmetsæˌkæmpːæ
metsämaasto	ˈmetsæˌmɑːsto
metsänemä	ˈmetsænˌemæ
metsänhoitotiede	ˈmetsænˌhoi̯toˌtie̯deˣ
metsänkäynti	ˈmetsænˌkæy̯nti
metsänsuojelu	ˈmetsænˌsuo̯jelu
metsäoppilaitos	ˈmetsæˌopːiˌlɑi̯tos
metsärikas	ˈmetsæˌrikɑs
metsästyskivääri	ˈmetsæstysˌkiʋæːri
metsästysseura	ˈmetsæstysˌseu̯rɑ
metsätalousalue	ˈmetsæˌtɑlousˌɑlueˣ
metsätalousvaliokunta	ˈmetsæˌtɑlousˌʋɑlioˌkuntɑ
metsätraktori	ˈmetsæˌtrɑktori
metsätyönjohtaja	ˈmetsæˌtyø̯nˌjohtɑjɑ
metsäympäristö	ˈmetsæˌympæristø
miau	ˈmiɑu
miehenalku	ˈmie̯henˌɑlku
miehikkäläinen	ˈmie̯hikːælæi̯nen
miehittää	ˈmie̯hitːæːˣ
miehyys	ˈmie̯hyːs
miekkamies	ˈmie̯kːɑˌmie̯s
mielenilmaisu	ˈmie̯lenˌilmɑi̯su
mielenmaltti	ˈmie̯lenˌmɑltːi
mielenterveydellisesti	ˈmie̯lenˌterʋey̯delːisestiˣ
mielenterveystyö	ˈmie̯lenˌterʋeysˌtyø̯
mielifilosofia	ˈmie̯liˌfilosofiɑ
mielikuvitusleikki	ˈmie̯liˌkuʋitusˌlei̯kːi
mielipidekirjallisuus	ˈmie̯liˌpideˣˌkirjɑlːisuːs
mieliruoka	ˈmie̯liˌruo̯kɑ
mielisuosio	ˈmie̯liˌsuo̯sio
miellyttäminen	ˈmie̯lːytːæminen
mieluisa	ˈmie̯lui̯sɑ
mieshukka	ˈmie̯sˌhukːɑ
mieskuorolaulu	ˈmie̯sˌkuo̯roˌlɑu̯lu
miesmäisesti	ˈmie̯smæi̯sestiˣ
miesraukka	ˈmie̯sˌrɑu̯kːɑ
miestenpyörä	ˈmie̯stenˌpyø̯ræ
miesvaltainen	ˈmie̯sˌʋɑltɑi̯nen
miesystävä	ˈmie̯sˌystæʋæ
mieto	ˈmie̯to
migreenikohtaus	ˈmiɡreːniˌkohtɑus
miimi	ˈmiːmi
miinavene	ˈmiːnɑˌʋeneˣ
miinustaa	ˈmiːnustɑːˣ
mikittää	ˈmikitːæːˣ
mikrobilääke	ˈmikrobiˌlæːkeˣ
mikrofoniliitäntä	ˈmikrofoniˌliːtæntæ
mikropiiri	ˈmikroˌpiːri
mikroskopoiminen	ˈmikroskopoi̯minen
mikrotukihenkilö	ˈmikroˌtukiˌheŋkilø
miksata	ˈmiksɑtɑˣ
miljoonainen	ˈmiljoːnɑi̯nen
miljoonasosa	ˈmiljoːnɑsˌosɑ
millainen	ˈmilːɑi̯nen
millisekunti	ˈmilːiˌsekunt(ː)i
mimmoinen	ˈmimːoi̯nen
mineraaliesiintymä	ˈminerɑːliˌesiːntymæ
mineralisaatio	ˈminerɑlisɑːtio
miniatyyrikokoinen	ˈminiɑtyːriˌkokoi̯nen
minikokoinen	ˈminiˌkokoi̯nen
minimipari	ˈminimiˌpɑri
ministerikausi	ˈministeriˌkɑu̯si
ministerivaltiosihteeri	ˈministeriˌʋɑltioˌsihteːri
minkinlainen	ˈmiŋkinˌlɑi̯nen
minkälainen	ˈmiŋkæˌlɑi̯nen
minttu	ˈmintːu
minunlaiseni	ˈminunˌlɑi̯seni
minäkäsitys	ˈminæˌkæsitys
miselli	ˈmiselːi
missiologia	ˈmisːioˌloɡiɑ
misu	ˈmisu
mitalitaiteilija	ˈmitɑliˌtɑi̯tei̯lijɑ
mitoittaminen	ˈmitoi̯tːɑminen
mittaamaton	ˈmitːɑːmɑton
mittakeppi	ˈmitːɑˌkepːi
mittarilento	ˈmitːɑriˌlento
mittatilaustyö	ˈmitːɑˌtilɑusˌtyø̯
mittaustulos	ˈmitːɑusˌtulos
mitä sanotaan	ˈmitæ ˈsɑnotɑːn
mitätöntää	ˈmitætøntæːˣ
mobiili	ˈmobiːli
modaalilogiikka	ˈmodɑːliˌloɡiːkːɑ
modernisti	ˈmodernisti
moduulirakenne	ˈmoduːliˌrɑkenːeˣ
moikata	ˈmoi̯kɑtɑˣ
moiskahtaa	ˈmoi̯skɑhtɑːˣ
moitittavasti	ˈmoi̯titːɑʋɑstiˣ
mojahtaa	ˈmojɑhtɑːˣ
mokkakakku	ˈmokːɑˌkɑkːu
moksahdus	ˈmoksɑhdus
molaalisuus	ˈmolɑːlisuːs
molekyylibiologia	ˈmolekyːliˌbioloɡiɑ
molekyylivoima	ˈmolekyːliˌʋoi̯mɑ
molo	ˈmolo
molske	ˈmolskeˣ
monarkkinen	ˈmonɑrkːinen
monenkokoinen	ˈmonenˌkokoi̯nen
monesko	ˈmonesko
mongolilainen	ˈmoŋːolilɑi̯nen
monialaistua	ˈmoniˌɑlɑi̯stuɑˣ
monihermosairaus	ˈmoniˌhermoˌsɑi̯rɑus
monikerroslevy	ˈmoniˌkerːosˌleʋy
monikäyttöauto	ˈmoniˌkæy̯tːøˌɑu̯to
monimielisesti	ˈmoniˌmie̯lisestiˣ
moninkertaistaa	ˈmoninˌkertɑi̯stɑːˣ
monipuolinen	ˈmoniˌpuo̯linen
monisatalukuinen	ˈmoniˌsɑtɑˌlukui̯nen
monistuminen	ˈmonistuminen
monitavuinen	ˈmoniˌtɑʋui̯nen
monitoimitila	ˈmoniˌtoi̯miˌtilɑ
moniurahihna	ˈmoniˌurɑˌhihnɑ
moniväripainatus	ˈmoniˌʋæriˌpɑi̯nɑtus
monoftongiutuminen	ˈmonoftoŋːiu̯tuminen
monometyylihydratsiini	ˈmonoˌmetyːliˌhydrɑtsiːni
monoteistinen	ˈmonoˌtei̯stinen
montanismi	ˈmontɑnismi
moottorikerho	ˈmoːtːoriˌkerho
moottoripyörä	ˈmoːtːoriˌpyø̯ræ
moottoritieverkosto	ˈmoːtːoriˌtie̯ˌʋerkosto
moottoriventtiili	ˈmoːtːoriˌʋentːiːli
mopoauto	ˈmopoˌɑu̯to
moraalikehitys	ˈmorɑːliˌkehitys
moreenikerros	ˈmoreːniˌkerːos
morkata	ˈmorkɑtɑˣ
morsettaminen	ˈmorsetːɑminen
morsiuskimppu	ˈmorsiusˌkimpːu
mosaiikkikuva	ˈmosɑi̯ːkːiˌkuʋɑ
moskeija	ˈmoskei̯jɑ
motivaatiopsykologia	ˈmotiʋɑːtioˌpsykoloɡiɑ
motti	ˈmotːi
moukarointi	ˈmou̯kɑroi̯nti
muhennus	ˈmuhenːus
muhkeus	ˈmuhkeus
muikeasti	ˈmui̯keɑstiˣ
muinainen	ˈmui̯nɑi̯nen
muinaiskaupunki	ˈmui̯nɑi̯sˌkɑu̯puŋki
muinaispelto	ˈmui̯nɑi̯sˌpelto
muinaisusko	ˈmui̯nɑi̯sˌusko
muisteleminen	ˈmui̯steleminen
muisti	ˈmui̯sti
muistiinmerkitä	ˈmui̯stiːnˌmerkitæˣ
muistilokero	ˈmui̯stiˌlokero
muistisairaus	ˈmui̯stiˌsɑi̯rɑus
muistoisa	ˈmui̯stoi̯sɑ
muistolle	ˈmui̯stolːeˣ
muistoruno	ˈmui̯stoˌruno
muistuttaminen	ˈmui̯stutːɑminen
mukaantuva	ˈmukɑːntuʋɑ
mukautumiskyky	ˈmukɑu̯tumisˌkyky
mukavoitua	ˈmukɑʋoi̯tuɑˣ
mukista	ˈmukistɑˣ
mukulakasvi	ˈmukulɑˌkɑsʋi
muliinilanka	ˈmuliːniˌlɑŋkɑ
muljeeraaminen	ˈmuljeːrɑːminen
mulkoilla	ˈmulkoi̯lːɑˣ
mullistaminen	ˈmulːistɑminen
mulskahdus	ˈmulskɑhdus
multapenkki	ˈmultɑˌpeŋkːi
multinomijakauma	ˈmultinomiˌjɑkɑu̯mɑ
mumma	ˈmumːɑ
munajuusto	ˈmunɑˌjuːsto
munanivel	ˈmunɑˌniʋel
munata	ˈmunɑtɑˣ
munittaa	ˈmunitːɑːˣ
munkkiluostari	ˈmuŋkːiˌluo̯stɑri
munuaismainen	ˈmunuɑi̯smɑi̯nen
muodinluoja	ˈmuo̯dinˌluo̯jɑ
muodoste	ˈmuo̯dosteˣ
muodostumislämpö	ˈmuo̯dostumisˌlæmpø
muokkaussyvyys	ˈmuo̯kːɑusˌsyʋyːs
muonittaja	ˈmuo̯nitːɑjɑ
muotiasu	ˈmuo̯tiˌɑsu
muotinäytös	ˈmuo̯tiˌnæy̯tøs
muotitoimittaja	ˈmuo̯tiˌtoi̯mitːɑjɑ
muotoaisti	ˈmuo̯toˌɑi̯sti
muotokaunis	ˈmuo̯toˌkɑu̯nis
muotolista	ˈmuo̯toˌlistɑ
muotoutuma	ˈmuo̯tou̯tumɑ
muovailla	ˈmuo̯ʋɑi̯lːɑˣ
muovi	ˈmuo̯ʋi
muovikyllästeinen	ˈmuo̯ʋiˌkylːæstei̯nen
muovilusikka	ˈmuo̯ʋiˌlusikːɑ
muovipullo	ˈmuo̯ʋiˌpulːo
muovitapetti	ˈmuo̯ʋiˌtɑpetːi
muovityö	ˈmuo̯ʋiˌtyø̯
murattiköynnös	ˈmurɑtːiˌkøy̯nːøs
mureketaikina	ˈmurekeˣˌtɑi̯kinɑ
mureutua	ˈmureu̯tuɑˣ
murhapoltto	ˈmurhɑˌpoltːo
murheissaan	ˈmurhei̯sːɑːn
murjottaminen	ˈmurjotːɑminen
murokakku	ˈmuroˌkɑkːu
murrehavainto	ˈmurːeˣˌhɑʋɑi̯nto
murresanakirja	ˈmurːeˣˌsɑnɑˌkirjɑ
murroste	ˈmurːosteˣ
murskailu	ˈmurskɑi̯lu
murskavoitto	ˈmurskɑˌʋoi̯tːo
murteenpuhuja	ˈmurteːnˌpuhujɑ
murtokuormitus	ˈmurtoˌkuo̯rmitus
murtoviivamittaus	ˈmurtoˌʋiːʋɑˌmitːɑus
murtunut	ˈmurtunut
museo-opetus	ˈmuseoˌ(ʔ)opetus
museoitua	ˈmuseoi̯tuɑˣ
museologia	ˈmuseoloɡiɑ
museotie	ˈmuseoˌtie̯
musiikinharrastaja	ˈmusiːkinˌhɑrːɑstɑjɑ
musiikkiautomaatti	ˈmusiːkːiˌɑu̯tomɑːtːi
musiikkikilpailu	ˈmusiːkːiˌkilpɑi̯lu
musiikkikustantamo	ˈmusiːkːiˌkustɑntɑmo
musiikkineuvos	ˈmusiːkːiˌneu̯ʋos
musiikkisemiotiikka	ˈmusiːkːiˌsemiotiːkːɑ
musiikkiäänite	ˈmusiːkːiˌæːniteˣ
muskettimies	ˈmusketːiˌmie̯s
musta lammas	ˈmustɑ ˈlɑmːɑs
mustajalka	ˈmustɑˌjɑlkɑ
mustalaisleiri	ˈmustɑlɑi̯sˌlei̯ri
mustamaalaaminen	ˈmustɑˌmɑːlɑːminen
mustanmerenlokki	ˈmustɑnˌmerenˌlokːi
mustapukuinen	ˈmustɑˌpukui̯nen
mustasilmä	ˈmustɑˌsilmæ
mustavalkoinen	ˈmustɑˌʋɑlkoi̯nen
muste	ˈmusteˣ
mustesuihkukirjoitin	ˈmusteˣˌsui̯hkuˌkirjoi̯tin
mustikkamaito	ˈmustikːɑˌmɑi̯to
mustuainen	ˈmustuɑi̯nen
mutageenisuus	ˈmutɑɡeːnisuːs
mutina	ˈmutinɑ
mutkistua	ˈmutkistuɑˣ
mutruun	ˈmutruːn
mututieto	ˈmutuˌtie̯to
muukalaisoikeus	ˈmuːkɑlɑi̯sˌoi̯keus
muumioituminen	ˈmuːmioi̯tuminen
muunnelmasarja	ˈmuːnːelmɑˌsɑrjɑ
muuntaminen	ˈmuːntɑminen
muuntokoulutus	ˈmuːntoˌkou̯lutus
muuramelainen	ˈmuːrɑmelɑi̯nen
muuri	ˈmuːri
muutoksenhakemus	ˈmuːtoksenˌhɑkemus
muutoslämpötila	ˈmuːtosˌlæmpøˌtilɑ
muutto	ˈmuːtːo
muuttovoitto	ˈmuːtːoˌʋoi̯tːo
muuttumisleikki	ˈmuːtːumisˌlei̯kːi
myelooinen	ˈmyeloːinen
mykerökukinto	ˈmykerøˌkukinto
mykkyys	ˈmykːyːs
myllertää	ˈmylːertæːˣ
myllyttäminen	ˈmylːytːæminen
myrkkyaine	ˈmyrkːyˌɑi̯neˣ
myrkkypäästö	ˈmyrkːyˌpæːstø
myrsky	ˈmyrsky
myrttiseppele	ˈmyrtːiˌsepːele
myy	ˈmyː
myymäläketju	ˈmyːmælæˌketju
myyntiartikkeli	ˈmyːntiˌɑrtikːeli
myyntilista	ˈmyːntiˌlistɑ
myyntipäivä	ˈmyːntiˌpæi̯ʋæ
myyrä	ˈmyːræ
myö	ˈmyø̯
myöhäisgoottilainen	ˈmyø̯hæi̯sˌɡoːtːilɑi̯nen
myöhäisohjelma	ˈmyø̯hæi̯sˌohjelmɑ
myöhästyttää	ˈmyø̯hæstytːæːˣ
myöntymätön	ˈmyø̯ntymætøn
myöntävä	ˈmyø̯ntæʋæ
myöstö	ˈmyø̯stø
myötäily	ˈmyø̯tæi̯ly
myötämielisesti	ˈmyø̯tæˌmie̯lisestiˣ
myötätunto	ˈmyø̯tæˌtunto
myötävärähtely	ˈmyø̯tæˌʋæræhtely
mädäntyä	ˈmædæntyæˣ
mäenlaskija	ˈmæenˌlɑskijɑ
mäike	ˈmæi̯keˣ
mäiskähdellä	ˈmæi̯skæhdelːæˣ
mäjähtää	ˈmæjæhtæːˣ
mäkistartti	ˈmækiˌstɑrtːi
mäkäräinen	ˈmækæræi̯nen
männynhavuöljy	ˈmænːynˌhɑʋuˌøljy
männynversosyöpä	ˈmænːynˌʋersoˌsyø̯pæ
mänty	ˈmænty
mäntykiitäjä	ˈmæntyˌkiːtæjæ
mäntysaippua	ˈmæntyˌsɑi̯pːuɑ
märehtijä	ˈmærehtijæ
märkäluja	ˈmærkæˌlujɑ
märssy	ˈmærsːy
mässäys	ˈmæsːæys
mätkähdellä	ˈmætkæhdelːæˣ
mättäminen	ˈmætːæminen
mätäs	ˈmætæs
määkyä	ˈmæːkyæˣ
määritteleminen	ˈmæːritːeleminen
määräaikaisesti	ˈmæːræˌɑi̯kɑi̯sestiˣ
määrähetki	ˈmæːræˌhetki
määrämitta	ˈmæːræˌmitːɑ
määrätietoisuus	ˈmæːræˌtie̯toi̯suːs
määrääjä	ˈmæːræːjæ
möhliminen	ˈmøhliminen
mökistä	ˈmøkistæ
mölisijä	ˈmølisijæ
mölähtäminen	ˈmølæhtæminen
mönjätä	ˈmønjætæˣ
mörskä	ˈmørskæ
möyheä	ˈmøy̯heæ
naakia	ˈnɑːkiɑˣ
naamat	ˈnɑːmɑt
naan	ˈnɑːn
naapurikateus	ˈnɑːpuriˌkɑteus
naapurivaltio	ˈnɑːpuriˌʋɑltio
naarauskoukku	ˈnɑːrɑusˌkou̯kːu
nabatealainen	ˈnɑbɑteɑlɑi̯nen
nahjus	ˈnɑhjus
nahkajäljitelmä	ˈnɑhkɑˌjæljitelmæ
nahkapaska	ˈnɑhkɑˌpɑskɑ
nahkarotsi	ˈnɑhkɑˌrotsi
nahkatuote	ˈnɑhkɑˌtuo̯teˣ
nahkurinverstas	ˈnɑhkurinˌʋerstɑs
nailonsiima	ˈnɑi̯lonˌsiːmɑ
naiminen	ˈnɑi̯minen
naisellistua	ˈnɑi̯selːistuɑˣ
naishahmo	ˈnɑi̯sˌhɑhmo
naisjoukkue	ˈnɑi̯sˌjou̯kːueˣ
naiskuva	ˈnɑi̯sˌkuʋɑ
naisoletettu	ˈnɑi̯sˌoletetːu
naissankari	ˈnɑi̯sˌsɑŋkɑri
naistenpyörä	ˈnɑi̯stenˌpyø̯ræ
naistutkimus	ˈnɑi̯sˌtutkimus
naisvaltikka	ˈnɑi̯sˌʋɑltikːɑ
naisystävä	ˈnɑi̯sˌystæʋæ
nakertelu	ˈnɑkertelu
nakkikeitto	ˈnɑkːiˌkei̯tːo
naksu	ˈnɑksu
nakutyttö	ˈnɑkuˌtytːø
nallilukko	ˈnɑlːiˌlukːo
nankiini	ˈnɑŋkiːni
nanoteknologia	ˈnɑnoˌteknoloɡiɑ
napajää	ˈnɑpɑˌjæː
napalanko	ˈnɑpɑˌlɑŋko
napata	ˈnɑpɑtɑˣ
napavirta	ˈnɑpɑˌʋirtɑ
nappikauppa	ˈnɑpːiˌkɑu̯pːɑ
nappulakenkä	ˈnɑpːulɑˌkeŋkæ
napsauttaminen	ˈnɑpsɑutːɑminen
narahtaminen	ˈnɑrɑhtɑminen
narkoleptinen	ˈnɑrkoleptinen
narri	ˈnɑrːi
narskunta	ˈnɑrskuntɑ
nasaalisesti	ˈnɑsɑːlisestiˣ
nasta	ˈnɑstɑ
natriumsuola	ˈnɑtriumˌsuo̯lɑ
natsismi	ˈnɑtsismi
nauhajohto	ˈnɑu̯hɑˌjohto
nauhamakaroni	ˈnɑu̯hɑˌmɑkɑroni
nauhoittaa	ˈnɑu̯hoi̯tːɑːˣ
naulanreikä	ˈnɑu̯lɑnˌrei̯kæ
nauraminen	ˈnɑu̯rɑminen
naurisvaras	ˈnɑu̯risˌʋɑrɑs
naurunrähäkkä	ˈnɑu̯runˌræhækːæ
nautakarjatila	ˈnɑu̯tɑˌkɑrjɑˌtilɑ
nautinta-alue	ˈnɑu̯tintɑˌ(ʔ)ɑlueˣ
navakka	ˈnɑʋɑkːɑ
neandertalinihminen	ˈneɑndertɑlinˌihminen
nefrologi	ˈnefroloɡi
neidonkukka	ˈnei̯donˌkukːɑ
neitseellisesti	ˈnei̯tseːlːisestiˣ
nekrofilia	ˈnekrofiliɑ
nelikenttäanalyysi	ˈneliˌkentːæˌɑnɑlyːsi
nelipuu	ˈneliˌpuː
nelistäminen	ˈnelistæminen
nelivuotinen	ˈneliˌʋuo̯tinen
neliöidä	ˈneliøi̯dæˣ
neliömetrivuokra	ˈneliøˌmetriˌʋuo̯krɑ
neljäkymmentä	ˈneljæˌkymːentæ
neljäs	ˈneljæs
neljävuotinen	ˈneljæˌʋuo̯tinen
nenä-mahaletku	ˈnenæˌmɑhɑˌletku
nenänpuoleinen	ˈnenænˌpuo̯lei̯nen
neogeeni	ˈneoɡeːni
nepata	ˈnepɑtɑˣ
nestefysiikka	ˈnesteˣˌfysiːkːɑ
nestekide	ˈnesteˣˌkideˣ
nestepumppu	ˈnesteˣˌpumpːu
nesteytyminen	ˈnestey̯tyminen
nettiaika	ˈnetːiˌɑi̯kɑ
nettisivu	ˈnetːiˌsiʋu
nettopalkka	ˈnetːoˌpɑlkːɑ
neulahuopamatto	ˈneu̯lɑˌhuo̯pɑˌmɑtːo
neulanterävä	ˈneu̯lɑnˌteræʋæ
neulelanka	ˈneu̯leˣˌlɑŋkɑ
neulominen	ˈneu̯lominen
neuraalitietokone	ˈneu̯rɑːliˌtie̯tokoneˣ
neurohypofyysi	ˈneu̯roˌhypofyːsi
neurosirkulatorinen	ˈneu̯roˌsirkulɑtorinen
neutralisaatiotekniikka	ˈneu̯trɑlisɑːtioˌtekniːkːɑ
neutroniluku	ˈneu̯troniˌluku
neuvontanumero	ˈneu̯ʋontɑˌnumero
neuvottelu	ˈneu̯ʋotːelu
neuvottelutulos	ˈneu̯ʋotːeluˌtulos
nevoittua	ˈneʋoi̯tːuɑˣ
nide	ˈnideˣ
nielu	ˈnie̯lu
nigiri	ˈniɡiri
niiaaminen	ˈniːɑːminen
niinityö	ˈniːniˌtyø̯
niiskuttaa	ˈniːskutːɑːˣ
niitti	ˈniːtːi
niittyheinä	ˈniːtːyˌhei̯næ
niittypirtti	ˈniːtːyˌpirtːi
nikealainen	ˈnikeɑlɑi̯nen
nikotiiniriippuvuus	ˈnikotiːniˌriːpːuʋuːs
niksua	ˈniksuɑˣ
nilkkakenkä	ˈnilkːɑˌkeŋkæ
nilkutus	ˈnilkutus
nimellisarvoinen	ˈnimelːisˌɑrʋoi̯nen
nimenhuutoäänestys	ˈnimenˌhuːtoˌæːnestys
nimestää	ˈnimestæːˣ
nimikilpi	ˈnimiˌkilpi
nimikkoseura	ˈnimikːoˌseu̯rɑ
nimileimasin	ˈnimiˌlei̯mɑsin
nimiosa	ˈnimiˌosɑ
nimismies	ˈnimisˌmie̯s
nimitutkimus	ˈnimiˌtutkimus
nippu-uitto	ˈnipːuˌ(ʔ)ui̯tːo
niputtaminen	ˈniputːɑminen
nirpassa	ˈnirpɑsːɑ
niska	ˈniskɑ
niskalenkkitoppi	ˈniskɑˌleŋkːiˌtopːi
niskatuki	ˈniskɑˌtuki
nisä	ˈnisæ
nitistää	ˈnitistæːˣ
nitraattifilmi	ˈnitrɑːtːiˌfilmi
niuha	ˈniu̯hɑ
niukkalajinen	ˈniu̯kːɑˌlɑjinen
nivalalainen	ˈniʋɑlɑlɑi̯nen
nivelliitos	ˈniʋelˌliːtos
nivelsairaus	ˈniʋelˌsɑi̯rɑus
niveräinen	ˈniʋeræi̯nen
noheva	ˈnoheʋɑ
noita-akka	ˈnoi̯tɑˌ(ʔ)ɑkːɑ
noja-asento	ˈnojɑˌ(ʔ)ɑsento
nokatusten	ˈnokɑtusten
nokimusta	ˈnokiˌmustɑ
nokittelu	ˈnokitːelu
nokkakolari	ˈnokːɑˌkolɑri
nokki	ˈnokːi
nokonnuuka	ˈnokonˌnuːkɑ
nolla-asteinen	ˈnolːɑˌ(ʔ)ɑstei̯nen
nollaluokka	ˈnolːɑˌluo̯kːɑ
nollatutkimus	ˈnolːɑˌtutkimus
nominaaliasteikko	ˈnominɑːliˌɑstei̯kːo
nonni	ˈnonːi(ˣ)
nopealiikkeinen	ˈnopeɑˌliːkːei̯nen
nopeudenrajoitin	ˈnopeu̯denˌrɑjoi̯tin
nopeutus	ˈnopeu̯tus
norjalaismies	ˈnorjɑlɑi̯sˌmie̯s
normaalikoulu	ˈnormɑːliˌkou̯lu
normaalipainoinen	ˈnormɑːliˌpɑi̯noi̯nen
normaaliälyinen	ˈnormɑːliˌælyi̯nen
normisidonnaisuus	ˈnormiˌsidonːɑi̯suːs
norsueläin	ˈnorsuˌelæi̯n
norua	ˈnoruɑˣ
nosto-ovi	ˈnostoˌ(ʔ)oʋi
nostolupa	ˈnostoˌlupɑ
nosturiauto	ˈnosturiˌɑu̯to
notkeagibboni	ˈnotkeɑˌɡibːoni
notkoselkä	ˈnotkoˌselkæ
nousukasmaisesti	ˈnou̯sukɑsˌmɑi̯sestiˣ
noutaja	ˈnou̯tɑjɑ
novellikirjailija	ˈnoʋelːiˌkirjɑi̯lijɑ
noviisi	ˈnoʋiːsi
nugaa	ˈnuɡɑː
nuhdella	ˈnuhdelːɑˣ
nuijakalastus	ˈnui̯jɑˌkɑlɑstus
nukahtamislääke	ˈnukɑhtɑmisˌlæːkeˣ
nukkaaminen	ˈnukːɑːminen
nukkefilmi	ˈnukːeˌfilmi
nukkuma-aika	ˈnukːumɑˌ(ʔ)ɑi̯kɑ
nukute	ˈnukuteˣ
nullifikaatio	ˈnulːifikɑːtio
numerollisesti	ˈnumerolːisestiˣ
numerosarja	ˈnumeroˌsɑrjɑ
nummi	ˈnumːi
nuo	ˈnuo̯
nuokkua	ˈnuo̯kːuɑˣ
nuolenpääkirjoitus	ˈnuo̯lenˌpæːˌkirjoi̯tus
nuolimainen	ˈnuo̯limɑi̯nen
nuorakeramiikka	ˈnuo̯rɑˌkerɑmiːkːɑ
nuorentuminen	ˈnuo̯rentuminen
nuoriso-osasto	ˈnuo̯risoˌ(ʔ)osɑsto
nuorisokirjailija	ˈnuo̯risoˌkirjɑi̯lijɑ
nuorisonhuolto	ˈnuo̯risonˌhuo̯lto
nuorisoromaani	ˈnuo̯risoˌromɑːni
nuorisotyönohjaaja	ˈnuo̯risoˌtyø̯nˌohjɑːjɑ
nuorsuomalaisuus	ˈnuo̯rˌsuo̯mɑlɑi̯suːs
nuortenohjelma	ˈnuo̯rtenˌohjelmɑ
nuoruudenlähde	ˈnuo̯ruːdenˌlæhdeˣ
nuoskasää	ˈnuo̯skɑˌsæː
nuotintaa	ˈnuo̯tintɑːˣ
nuotiotuli	ˈnuo̯tioˌtuli
nuottiarvo	ˈnuo̯tːiˌɑrʋo
nupopäinen	ˈnupoˌpæi̯nen
nupukivi	ˈnupuˌkiʋi
nurinmeno	ˈnurinˌmeno
nurkata	ˈnurkɑtɑˣ
nurkkakuntaisesti	ˈnurkːɑˌkuntɑi̯sestiˣ
nurkumattomuus	ˈnurkumɑtːomuːs
nurmipallo	ˈnurmiˌpɑlːo
nuta	ˈnutɑ
nutukas	ˈnutukɑs
nuuskatupakka	ˈnuːskɑˌtupɑkːɑ
nyde	ˈnydeˣ
nykerö	ˈnykerø
nykyasu	ˈnykyˌɑsu
nykyolot	ˈnykyˌolot
nykyttäminen	ˈnykytːæminen
nynnerö	ˈnynːerø
nyreys	ˈnyreys
nyrkkirieska	ˈnyrkːiˌrie̯skɑ
nystermä	ˈnystermæ
nytkähtäminen	ˈnytkæhtæminen
nyymi	ˈnyːmi
nyökyttää	ˈnyø̯kytːæːˣ
nähdessä	ˈnæhdesːæ
näin päin	ˈnæi̯n ˈpæi̯n
näkijä	ˈnækijæ
näkyminen	ˈnækyminen
näkyviltä	ˈnækyʋiltæ
näkö	ˈnækø
näköispainos	ˈnækøi̯sˌpɑi̯nos
näköpuhelin	ˈnækøˌpuhelin
näkövinkkeli	ˈnækøˌʋiŋkːeli
nälväisy	ˈnælʋæi̯sy
näpistää	ˈnæpistæːˣ
näppäinharmonikka	ˈnæpːæi̯nˌhɑrmonikːɑ
näpsäkkä	ˈnæpsækːæ
näpäkkä	ˈnæpækːæ
närkästyminen	ˈnærkæstyminen
näskäin	ˈnæskæi̯n
näyte	ˈnæy̯teˣ
näytelmämusiikki	ˈnæy̯telmæˌmusiːkːi
näyteväli	ˈnæy̯teˣˌʋæli
näytteleminen	ˈnæy̯tːeleminen
näyttelyjulkaisu	ˈnæy̯tːelyˌjulkɑi̯su
näyttis	ˈnæy̯tːis
näyttämöliikunta	ˈnæy̯tːæmøˌliːkuntɑ
näyttämötekniikka	ˈnæy̯tːæmøˌtekniːkːɑ
näyttömuisti	ˈnæy̯tːøˌmui̯sti
näytäntövuosi	ˈnæy̯tæntøˌʋuo̯si
näännyksiin	ˈnæːnːyksiːn
nöf	ˈnøf
nöyrtyminen	ˈnøy̯rtyminen
obeliski	ˈobeliski
obliikvi	ˈobliːkʋi
odottamatta	ˈodotːɑmɑtːɑ
offshoretekniikka	ˈofˌsoːrˌtekniːkːɑ
oheistulostin	ˈohei̯sˌtulostin
ohikiitävä	ˈohiˌkiːtæʋæ
ohipuhuminen	ˈohiˌpuhuminen
ohivirtaussuihkumoottori	ˈohiˌʋirtɑusˌsui̯hkuˌmoːtːori
ohjailu	ˈohjɑi̯lu
ohjauskoodi	ˈohjɑusˌkoːdi
ohjausvuoro	ˈohjɑusˌʋuo̯ro
ohjelma	ˈohjelmɑ
ohjelmavälitys	ˈohjelmɑˌʋælitys
ohjelmistoversio	ˈohjelmistoˌʋersio
ohjushyökkäys	ˈohjusˌhyø̯kːæys
ohramallas	ˈohrɑˌmɑlːɑs
ohutkerroskromatografia	ˈohutˌkerːosˌkromɑtoɡrɑfiɑ
oikaisuyritys	ˈoi̯kɑi̯suˌyritys
oikeapituinen	ˈoi̯keɑˌpitui̯nen
oikeudenhoito	ˈoi̯keu̯denˌhoi̯to
oikeudentuntoinen	ˈoi̯keu̯denˌtuntoi̯nen
oikeusasia	ˈoi̯keusˌɑsiɑ
oikeusistuin	ˈoi̯keusˌistui̯n
oikeuskäsitys	ˈoi̯keusˌkæsitys
oikeusneuvosmies	ˈoi̯keusˌneu̯ʋosˌmie̯s
oikeuspositivismi	ˈoi̯keusˌpositiʋismi
oikeussuhde	ˈoi̯keusˌsuhdeˣ
oikeustieteellinen	ˈoi̯keusˌtie̯teːlːinen
oikeustutkinto	ˈoi̯keusˌtutkinto
oikoa	ˈoi̯koɑˣ
oikosulkumoottori	ˈoi̯koˌsulkuˌmoːtːori
oireyhtymä	ˈoi̯reˣˌyhtymæ
ojentua	ˈojentuɑˣ
okklusaalinen	ˈokːlusɑːlinen
oksa	ˈoksɑ
oksennustauti	ˈoksenːusˌtɑu̯ti
oksi	ˈoksi
oksitaani	ˈoksitɑːni
okulaari	ˈokulɑːri
olemassaolo	ˈolemɑsːɑˌolo
oleskelija	ˈoleskelijɑ
oletus	ˈoletus
oligoseenikausi	ˈoliɡoseːniˌkɑu̯si
olkakirves	ˈolkɑˌkirʋes
olkikatto	ˈolkiˌkɑtːo
olmi	ˈolmi
olotila	ˈoloˌtilɑ
olympolainen	ˈolympolɑi̯nen
omahoito	ˈomɑˌhoi̯to
omaisuudenhoitoyhtiö	ˈomɑi̯suːdenˌhoi̯toˌyhtiø
omakehu	ˈomɑˌkehu
omakotitaloalue	ˈomɑˌkotiˌtɑloˌɑlueˣ
omakustannus	ˈomɑˌkustɑnːus
omalakisuus	ˈomɑˌlɑkisuːs
omanlainen	ˈomɑnlɑi̯nen
omantunnonvapaus	ˈomɑnˌtunːonˌʋɑpɑus
omarahoitusosuus	ˈomɑˌrɑhoi̯tusˌosuːs
omavalintainen	ˈomɑˌʋɑlintɑi̯nen
omavastuisesti	ˈomɑˌʋɑstui̯sestiˣ
omenainen	ˈomenɑi̯nen
omikron	ˈomikron
ominaisliike	ˈominɑi̯sˌliːkeˣ
ominpäin	ˈominˌpæi̯n
omistajavalta	ˈomistɑjɑˌʋɑltɑ
omistusasuminen	ˈomistusˌɑsuminen
omistusliitteinen	ˈomistusˌliːtːei̯nen
ompeleminen	ˈompeleminen
onania	ˈonɑniɑ
onkia	ˈoŋkiɑˣ
onneksi	ˈonːeksi
ontelo	ˈontelo
ontologia	ˈontoloɡiɑ
oopperarepertoaari	ˈoːpːerɑˌrepertoɑːri
opastin	ˈopɑstin
opettaa	ˈopetːɑːˣ
opetteleminen	ˈopetːeleminen
opetuskäyttö	ˈopetusˌkæy̯tːø
opetustila	ˈopetusˌtilɑ
opetusvirka	ˈopetusˌʋirkɑ
opinto-opas	ˈopintoˌ(ʔ)opɑs
opintokokonaisuus	ˈopintoˌkokonɑi̯suːs
opintosuoritus	ˈopintoˌsuo̯ritus
opioidireseptori	ˈopioi̯diˌreseptori
opiskelijalevottomuudet	ˈopiskelijɑˌleʋotːomuːdet
opiskeluaikainen	ˈopiskeluˌɑi̯kɑi̯nen
opistoaste	ˈopistoˌɑsteˣ
oppiarvo	ˈopːiˌɑrʋo
oppilashuolto	ˈopːilɑsˌhuo̯lto
oppimispsykologi	ˈopːimisˌpsykoˌloɡi
oppivelvollinen	ˈopːiˌʋelʋolːinen
optimoida	ˈoptimoi̯dɑˣ
orakko	ˈorɑkːo
orastaminen	ˈorɑstɑminen
organelli	ˈorɡɑnelːi
organogeneesi	ˈorɡɑnoˌɡeneːsi
orimattilalainen	ˈoriˌmɑtːilɑlɑi̯nen
orjuuttaa	ˈorjuːtːɑːˣ
orneerata	ˈorneːrɑtɑˣ
orsivesi	ˈorsiˌʋesi
ortografia	ˈortoɡrɑfiɑ
orvakka	ˈorʋɑkːɑ
osa-aikaisuus	ˈosɑˌ(ʔ)ɑi̯kɑi̯suːs
osakemyynti	ˈosɑkeˣˌmyːnti
osaketalo	ˈosɑkeˣˌtɑlo
osakuntaelämä	ˈosɑˌkuntɑˌelæmæ
osallistumisaktiivisuus	ˈosɑlːistumisˌɑktiːʋisuːs
osamaksuluotto	ˈosɑˌmɑksuˌluo̯tːo
osanottajavaltio	ˈosɑnˌotːɑjɑˌʋɑltio
osapalkkio	ˈosɑˌpɑlkːio
osapäivätyö	ˈosɑˌpæi̯ʋæˌtyø̯
osastollinen	ˈosɑstolːinen
osasyy	ˈosɑˌsyː
osavalmistus	ˈosɑˌʋɑlmistus
oseanologia	ˈoseɑnoloɡiɑ
osinkoprosentti	ˈosiŋkoˌprosentːi
osittaisderivoida	ˈositːɑi̯sˌderiʋoi̯dɑˣ
osmonsolmu	ˈosmonˌsolmu
osoiterekisteri	ˈosoi̯teˣˌrekisteri
osoittaja	ˈosoi̯tːɑjɑ
ostari	ˈostɑri
osto-opas	ˈostoˌ(ʔ)opɑs
ostokriteeri	ˈostoˌkriteːri
ostopaine	ˈostoˌpɑi̯neˣ
ostospaikka	ˈostosˌpɑi̯kːɑ
osuma	ˈosumɑ
osuuskirja	ˈosuːsˌkirjɑ
osuusteurastamo	ˈosuːsˌteu̯rɑstɑmo
osviitta	ˈosʋiːtːɑ
otattaa	ˈotɑtːɑːˣ
otos	ˈotos
otsalauta	ˈotsɑˌlɑu̯tɑ
otsoniaukko	ˈotsoniˌɑu̯kːo
ottaa onkeensa	ˈotːɑːˣ ˈoŋkeːnsɑˣ
ottajainen	ˈotːɑjɑi̯nen
oudoksuminen	ˈou̯doksuminen
outolintu	ˈou̯toˌlintu
paahtoleipä	ˈpɑːhtoˌlei̯pæ
paali	ˈpɑːli
paaluveto	ˈpɑːluˌʋeto
paapoa	ˈpɑːpoɑˣ
paavi	ˈpɑːʋi
paaši	ˈpɑːʃi
paeta	ˈpɑetɑˣ
pahanilkinen	ˈpɑhɑnˌilkinen
pahantapainen	ˈpɑhɑnˌtɑpɑi̯nen
pahaääninen	ˈpɑhɑˌæːninen
pahentaa	ˈpɑhentɑːˣ
pahkainen	ˈpɑhkɑi̯nen
pahoilleen	ˈpɑhoi̯lːeːn
paholainen	ˈpɑholɑi̯nen
pahvirasia	ˈpɑhʋiˌrɑsiɑ
paijaaminen	ˈpɑi̯jɑːminen
paikalleen	ˈpɑi̯kɑlːeːn
paikallishistoria	ˈpɑi̯kɑlːisˌhistoriɑ
paikallislinja	ˈpɑi̯kɑlːisˌlinjɑ
paikallisradio	ˈpɑi̯kɑlːisˌrɑdio
paikallistuntemus	ˈpɑi̯kɑlːisˌtuntemus
paikannimistö	ˈpɑi̯kɑnˌnimistø
paikata	ˈpɑi̯kɑtɑˣ
paikkakortti	ˈpɑi̯kːɑˌkortːi
paikkatieto	ˈpɑi̯kːɑˌtie̯to
paikkoheitto	ˈpɑi̯kːoˌhei̯tːo
paikoittain	ˈpɑi̯koi̯tːɑi̯n
paimenharakka	ˈpɑi̯menˌhɑrɑkːɑ
paimentaa	ˈpɑi̯mentɑːˣ
paimentorvi	ˈpɑi̯menˌtorʋi
painaltaa	ˈpɑi̯nɑltɑːˣ
painatustyö	ˈpɑi̯nɑtusˌtyø̯
paineenalainen	ˈpɑi̯neːnˌɑlɑi̯nen
paineensäädin	ˈpɑi̯neːnˌsæːdin
paineilmakäyttöinen	ˈpɑi̯neˣˌilmɑˌkæy̯tːøi̯nen
paineistaminen	ˈpɑi̯nei̯stɑminen
painella	ˈpɑi̯nelːɑˣ
painesäiliö	ˈpɑi̯neˣˌsæi̯liø
painijoukkue	ˈpɑi̯niˌjou̯kːueˣ
paino	ˈpɑi̯no
painoinen	ˈpɑi̯noi̯nen
painokivi	ˈpɑi̯noˌkiʋi
painoluokka	ˈpɑi̯noˌluo̯kːɑ
painopaikka	ˈpɑi̯noˌpɑi̯kːɑ
painorajoitus	ˈpɑi̯noˌrɑjoi̯tus
painosylinteri	ˈpɑi̯noˌsylinteri
painotyö	ˈpɑi̯noˌtyø̯
painoyksikkö	ˈpɑi̯noˌyksikːø
paisetauti	ˈpɑi̯seˣˌtɑu̯ti
paistihaarukka	ˈpɑi̯stiˌhɑːrukːɑ
paistinuuni	ˈpɑi̯stinˌuːni
paistorasva	ˈpɑi̯stoˌrɑsʋɑ
paisuttelu	ˈpɑi̯sutːelu
paitasillaan	ˈpɑi̯tɑsilːɑːn
pajakalusto	ˈpɑjɑˌkɑlusto
pajukori	ˈpɑjuˌkori
pajupuu	ˈpɑjuˌpuː
pakahtuminen	ˈpɑkɑhtuminen
pakastamo	ˈpɑkɑstɑmo
pakasteteippi	ˈpɑkɑsteˣˌtei̯pːi
pakeillaan	ˈpɑkei̯lːɑːn
paketillinen	ˈpɑketilːinen
pakettinaru	ˈpɑketːiˌnɑru
pakinatyylinen	ˈpɑkinɑˌtyːlinen
pakkaamo	ˈpɑkːɑːmo
pakkasenkestävyys	ˈpɑkːɑsenˌkestæʋyːs
pakkaslukema	ˈpɑkːɑsˌlukemɑ
pakkasyö	ˈpɑkːɑsˌyø̯
pakkaustarvike	ˈpɑkːɑusˌtɑrʋikeˣ
pakki	ˈpɑkːi
pakkokuolaimet	ˈpɑkːoˌkuo̯lɑi̯met
pakkoluovutus	ˈpɑkːoˌluo̯ʋutus
pakkorako	ˈpɑkːoˌrɑko
pakkotoimenpide	ˈpɑkːoˌtoi̯menˌpideˣ
pakoilla	ˈpɑkoi̯lːɑˣ
pakolinna	ˈpɑkoˌlinːɑ
pakostakin	ˈpɑkostɑkin
pakovesi	ˈpɑkoˌʋesi
paksunema	ˈpɑksunemɑ
paksupäinen	ˈpɑksuˌpæi̯nen
paku	ˈpɑku
palamisreaktio	ˈpɑlɑmisˌreɑktio
palataali	ˈpɑlɑtɑːli
palatalisoitu	ˈpɑlɑtɑlisoi̯tu
palaute	ˈpɑlɑu̯teˣ
palautuskaava	ˈpɑlɑu̯tusˌkɑːʋɑ
palaveerata	ˈpɑlɑʋeːrɑtɑˣ
paleltumisvamma	ˈpɑleltumisˌʋɑmːɑ
paleoekologia	ˈpɑleoˌekoloɡiɑ
palhoaminen	ˈpɑlhoɑminen
paljas pinta	ˈpɑljɑs ˈpintɑ
paljastuminen	ˈpɑljɑstuminen
paljinsolki	ˈpɑljinˌsolki
palkanalennus	ˈpɑlkɑnˌɑlenːus
palkannauttija	ˈpɑlkɑnˌnɑu̯tːijɑ
palkinnonsaaja	ˈpɑlkinːonˌsɑːjɑ
palkintomitali	ˈpɑlkintoˌmitɑl(ː)i
palkka-armeija	ˈpɑlkːɑˌ(ʔ)ɑrmei̯jɑ
palkkaindeksi	ˈpɑlkːɑˌindeksi
palkkakustannukset	ˈpɑlkːɑˌkustɑnːukset
palkkaperuste	ˈpɑlkːɑˌperusteˣ
palkkataso	ˈpɑlkːɑˌtɑso
palkkautua	ˈpɑlkːɑu̯tuɑˣ
palkohedelmä	ˈpɑlkoˌhedelmæ
palli	ˈpɑlːi
pallohiili	ˈpɑlːoˌhiːli
pallokolmio	ˈpɑlːoˌkolmio
pallonheitto	ˈpɑlːonˌhei̯tːo
palloperuna	ˈpɑlːoˌperunɑ
pallosektori	ˈpɑlːoˌsektori
palloventtiili	ˈpɑlːoˌʋentːiːli
palmikoiminen	ˈpɑlmikoi̯minen
palmuranta	ˈpɑlmuˌrɑntɑ
paloesimies	ˈpɑloˌesiˌmie̯s
palokalusto	ˈpɑloˌkɑlusto
palokuntalainen	ˈpɑloˌkuntɑlɑi̯nen
palomiehistö	ˈpɑloˌmie̯histø
palonsuoja-aine	ˈpɑlonˌsuo̯jɑˌ(ʔ)ɑi̯neˣ
palosuoja-aine	ˈpɑloˌsuo̯jɑˌ(ʔ)ɑi̯neˣ
paloturvallinen	ˈpɑloˌturʋɑlːinen
palpoiminen	ˈpɑlpoi̯minen
palstantäyte	ˈpɑlstɑnˌtæy̯teˣ
paluu	ˈpɑluː
paluurahti	ˈpɑluːˌrɑhti
palvella	ˈpɑlʋelːɑˣ
palvelukanava	ˈpɑlʋeluˌkɑnɑʋɑ
palvelumyymälä	ˈpɑlʋeluˌmyːmælæ
palvelupuhelin	ˈpɑlʋeluˌpuhelin
palvelusrikos	ˈpɑlʋelusˌrikos
palvelutyyppi	ˈpɑlʋeluˌtyːpːi
palvimakkara	ˈpɑlʋiˌmɑkːɑrɑ
pamauttaminen	ˈpɑmɑutːɑminen
panarabialainen	ˈpɑnˌɑrɑbiɑlɑi̯nen
paneli	ˈpɑneli
paneutua	ˈpɑneu̯tuɑˣ
paniini	ˈpɑniːni
pankkiala	ˈpɑŋkːiˌɑlɑ
pankkineiti	ˈpɑŋkːiˌnei̯ti
pankkitarkastus	ˈpɑŋkːiˌtɑrkɑstus
pankko	ˈpɑŋkːo
pannoittaa	ˈpɑnːoi̯tːɑːˣ
pannunmyssy	ˈpɑnːunˌmysːy
panos	ˈpɑnos
panssariase	ˈpɑnsːɑriˌɑseˣ
panssarimaali	ˈpɑnsːɑriˌmɑːli
panssarisiimalevä	ˈpɑnsːɑriˌsiːmɑˌleʋæ
pantata	ˈpɑntɑtɑˣ
panttaus	ˈpɑntːɑus
panttivankidraama	ˈpɑntːiˌʋɑŋkiˌdrɑːmɑ
paperi	ˈpɑperi
paperikauppa	ˈpɑperiˌkɑu̯pːɑ
paperilaji	ˈpɑperiˌlɑji
paperilyhty	ˈpɑperiˌlyhty
paperinpalanen	ˈpɑperinˌpɑlɑnen
paperipuu	ˈpɑperiˌpuː
paperisäkki	ˈpɑperiˌsækːi
paperiveitsi	ˈpɑperiˌʋei̯tsi
papinpuku	ˈpɑpinˌpuku
paprikasumutin	ˈpɑprikɑˌsumutin
para	ˈpɑrɑ
paraatipelastus	ˈpɑrɑːtiˌpelɑstus
parafraasi	ˈpɑrɑˌfrɑːsi
paraillaan	ˈpɑrɑi̯lːɑːn
paralleeli	ˈpɑrɑlːeːli
parannuksentekijä	ˈpɑrɑnːuksenˌtekijæ
paranoidisesti	ˈpɑrɑnoi̯disestiˣ
parantumattomuus	ˈpɑrɑntumɑtːomuːs
parataktinen	ˈpɑrɑtɑktinen
parayleisurheilu	ˈpɑrɑˌylei̯sˌurhei̯lu
parenkyymi	ˈpɑreŋkyːmi
pariairokaksikko	ˈpɑriˌɑi̯roˌkɑksikːo
parijakoinen	ˈpɑriˌjɑkoi̯nen
parilehdykkäinen	ˈpɑriˌlehdykːæi̯nen
parinvaihtotanssi	ˈpɑrinˌʋɑi̯htoˌtɑnsːi
parisatainen	ˈpɑriˌsɑtɑi̯nen
parisuhdeaika	ˈpɑriˌsuhdeˣˌɑi̯kɑ
parittaminen	ˈpɑritːɑminen
pariutua	ˈpɑriu̯tuɑˣ
parjata	ˈpɑrjɑtɑˣ
parkitseminen	ˈpɑrkitseminen
parkkialue	ˈpɑrkːiˌɑlueˣ
parkkivalo	ˈpɑrkːiˌʋɑlo
parlamentarisoida	ˈpɑrlɑmentɑrisoi̯dɑˣ
parodioida	ˈpɑrodioi̯dɑˣ
parrantynkä	ˈpɑrːɑnˌtyŋkæ
parseli	ˈpɑrseli
partahaiven	ˈpɑrtɑˌhɑi̯ʋen
partasuti	ˈpɑrtɑˌsuti
partiojohtaja	ˈpɑrtioˌjohtɑjɑ
partioretki	ˈpɑrtioˌretki
parturinsakset	ˈpɑrturinˌsɑkset
parvekelaatikko	ˈpɑrʋekeˣˌlɑːtikːo
parvilintu	ˈpɑrʋiˌlintu
paska	ˈpɑskɑ
passaaminen	ˈpɑsːɑːminen
passiivinen	ˈpɑsːiːʋinen
passionhedelmä	ˈpɑsːionˌhedelmæ
pastajuotos	ˈpɑstɑˌjuo̯tos
pastellinsävyinen	ˈpɑstelːinˌsæʋyi̯nen
pastoraalinen	ˈpɑstorɑːlinen
pasuri	ˈpɑsuri
patalaiska	ˈpɑtɑˌlɑi̯skɑ
patavanhoillinen	ˈpɑtɑˌʋɑnhoi̯lːinen
patentoiminen	ˈpɑtentoi̯minen
patenttineuvos	ˈpɑtentːiˌneu̯ʋos
patikka	ˈpɑtikːɑ
patjakasvi	ˈpɑtjɑˌkɑsʋi
patokalastus	ˈpɑtoˌkɑlɑstus
patriarkaalinen	ˈpɑtriˌɑrkɑːlinen
patruunalipas	ˈpɑtruːnɑˌlipɑs
patti	ˈpɑtːi
patvi	ˈpɑtʋi
paukkua	ˈpɑu̯kːuɑˣ
paula	ˈpɑu̯lɑ
paviaani	ˈpɑʋiɑːni
pedersöreläinen	ˈpe(ː)dersø(ː)relæi̯nen
peevelisti	ˈpeːʋelistiˣ
pehmentää	ˈpehmentæːˣ
pehmeäpiirteinen	ˈpehmeæˌpiːrtei̯nen
pehmite	ˈpehmiteˣ
pehmoilla	ˈpehmoi̯lːɑˣ
pehmustaminen	ˈpehmustɑminen
pehtori	ˈpehtori
peilausmatriisi	ˈpei̯lɑusˌmɑtriːsi
peilinkehys	ˈpei̯linˌkehys
peippi	ˈpei̯pːi
peitepuikko	ˈpei̯teˣˌpui̯kːo
peitinkarva	ˈpei̯tinˌkɑrʋɑ
peittaväri	ˈpei̯tːɑˌʋæri
peittäytyä	ˈpei̯tːæy̯tyæˣ
pekonimakkara	ˈpekoniˌmɑkːɑrɑ
pelastuskalusto	ˈpelɑstusˌkɑlusto
pelastusyksikkö	ˈpelɑstusˌyksikːø
pelierä	ˈpeliˌeræ
pelikatko	ˈpeliˌkɑtko
pelimies	ˈpeliˌmie̯s
pelipöytä	ˈpeliˌpøy̯tæ
peliteoreetikko	ˈpeliˌteoreːtikːo
peliäly	ˈpeliˌæly
pelkkä	ˈpelkːæ
pelkääjänpuoleinen	ˈpelkæːjænˌpuo̯lei̯nen
pellavaliina	ˈpelːɑʋɑˌliːnɑ
pellavaöljyhappo	ˈpelːɑʋɑˌøljyˌhɑpːo
pelletöinti	ˈpelːetøi̯nti
pellonvaraus	ˈpelːonˌʋɑrɑus
pelonsekainen	ˈpelonˌsekɑi̯nen
pelottelu	ˈpelotːelu
peltikatto	ˈpeltiˌkɑtːo
peltirasia	ˈpeltiˌrɑsiɑ
peltivaurio	ˈpeltiˌʋɑu̯rio
peltoetana	ˈpeltoˌetɑnɑ
peltotaskuruoho	ˈpeltoˌtɑskuˌruo̯ho
peluriluonne	ˈpeluriˌluo̯nːeˣ
pemfigoidi	ˈpemfiɡoi̯di
pengertäminen	ˈpeŋːertæminen
penikuorma	ˈpeniˌkuo̯rmɑ
penkereisyys	ˈpeŋkerei̯syːs
penkkirivi	ˈpeŋkːiˌriʋi
pensaskoira	ˈpensɑsˌkoi̯rɑ
pensastua	ˈpensɑstuɑˣ
pentaedri	ˈpentɑedri
pentukoira	ˈpentuˌkoi̯rɑ
pepperoni	ˈpepːeroni
perehdyttää	ˈperehdytːæːˣ
peremmältä	ˈperemːæltæ
performanssitaiteilija	ˈperformɑnsːiˌtɑi̯tei̯lijɑ
perhe-eläke	ˈperheˣˌelækeˣ
perheenisä	ˈperheːnˌisæ
perhejuhla	ˈperheˣˌjuhlɑ
perhekäyttö	ˈperheˣˌkæy̯tːø
perhepakkaus	ˈperheˣˌpɑkːɑus
perhesosiologia	ˈperheˣˌsosioloɡiɑ
perhetyttö	ˈperheˣˌtytːø
perho-onginta	ˈperhoˌ(ʔ)oŋːintɑ
perhoskokoelma	ˈperhosˌkokoelmɑ
periaatteettomuus	ˈperiˌɑːtːeːtːomuːs
perikoroniitti	ˈperikoroniːtːi
perimisjärjestys	ˈperimisˌjærjestys
perimä	ˈperimæ
perinnelajianalyysi	ˈperinːeˣˌlɑjiˌɑnɑlyːsi
perinnäisesti	ˈperinːæi̯sestiˣ
perinnönjättäjä	ˈperinːønˌjætːæjæ
perintäkulu	ˈperintæˌkulu
perintöosa	ˈperintøˌosɑ
periodisesti	ˈperiodisestiˣ
periyttää	ˈperiytːæːˣ
perjantaisin	ˈperjɑntɑi̯sin
perkeleenmoinen	ˈperkeleːnˌmoi̯nen
permanto	ˈpermɑnto
permu	ˈpermu
pernisioosinen	ˈpernisioːsinen
perseet	ˈperseːt
persialaissota	ˈpersiɑlɑi̯sˌsotɑ
persiljanjuuri	ˈpersiljɑnˌjuːri
persoilu	ˈpersoi̯lu
persoonallisuushäiriöinen	ˈpersoːnɑlːisuːsˌhæi̯riøi̯nen
perspektiivikuva	ˈperspektiːʋiˌkuʋɑ
perunainen	ˈperunɑi̯nen
perunalettu	ˈperunɑˌletːu
perunanistutuskone	ˈperunɑnˌistutusˌkoneˣ
perunannostokone	ˈperunɑnˌnostoˌkoneˣ
perunapiirakka	ˈperunɑˌpiːrɑkːɑ
perunasyöpä	ˈperunɑˌsyø̯pæ
perus	ˈperus
perusasento	ˈperusˌɑsento
perusjoukko	ˈperusˌjou̯kːo
peruskorkosidonnainen	ˈperusˌkorkoˌsidonːɑi̯nen
peruskurssi	ˈperusˌkursːi
perusluonne	ˈperusˌluo̯nːeˣ
perusnäyttely	ˈperusˌnæy̯tːely
peruspaalu	ˈperusˌpɑːlu
peruspuku	ˈperusˌpuku
perussijoitus	ˈperusˌsijoi̯tus
perustamiskokous	ˈperustɑmisˌkokous
peruste	ˈperusteˣ
perustella	ˈperustelːɑˣ
perustuksellinen	ˈperustukselːinen
perustuslakituomioistuin	ˈperustusˌlɑkiˌtuo̯mioˌistui̯n
perusvuosi	ˈperusˌʋuo̯si
peruuttamisoikeus	ˈperuːtːɑmisˌoi̯keus
pervoilla	ˈperʋoi̯lːɑˣ
peräkaneetti	ˈperæˌkɑneːtːi
peräköysi	ˈperæˌkøy̯si
perämiehellinen	ˈperæˌmie̯helːinen
peräpainoisuus	ˈperæˌpɑi̯noi̯suːs
peräranka	ˈperæˌrɑŋkɑ
perässätulija	ˈperæsːæˌtulijɑ
perättömyys	ˈperætːømyːs
perääminen	ˈperæːminen
perääntymiskäsky	ˈperæːntymisˌkæsky
pesijä	ˈpesijæ
pesis	ˈpesis
pestautua	ˈpestɑu̯tuɑˣ
pesuaineteollisuus	ˈpesuˌɑi̯neˣˌteolːisuːs
pesukarttu	ˈpesuˌkɑrtːu
pesupalju	ˈpesuˌpɑlju
pesutila	ˈpesuˌtilɑ
pesäloinen	ˈpesæˌloi̯nen
pesäpallisti	ˈpesæˌpɑlːisti
pesäpuu	ˈpesæˌpuː
petauspatja	ˈpetɑusˌpɑtjɑ
petoksellinen	ˈpetokselːinen
petsi	ˈpetsi
pettyminen	ˈpetːyminen
peukalokiila	ˈpeu̯kɑloˌkiːlɑ
peurankello	ˈpeu̯rɑnˌkelːo
pianistinen	ˈpiɑnistinen
pianokvintetti	ˈpiɑnoˌkʋintetːi
pianosävellys	ˈpiɑnoˌsæʋelːys
pidentyminen	ˈpidentyminen
pidäkkeettömästi	ˈpidækːeːtːømæstiˣ
pidättää	ˈpidætːæːˣ
pieksentä	ˈpie̯ksentæ
pielestäminen	ˈpie̯lestæminen
pienasunto	ˈpie̯nˌɑsunto
pienennellä	ˈpie̯nenːelːæˣ
pienikaliiperinen	ˈpie̯niˌkɑliːperinen
pienipiirteinen	ˈpie̯niˌpiːrtei̯nen
pienkerrostalo	ˈpie̯nˌkerːosˌtɑlo
pienmetalli	ˈpie̯nˌmetɑlːi
pienoisjännitteinen	ˈpie̯noi̯sˌjænːitːei̯nen
pienoisliesi	ˈpie̯noi̯sˌlie̯si
pienoisooppera	ˈpie̯noi̯sˌoːpːerɑ
pienomistaja	ˈpie̯nˌomistɑjɑ
pienpuhdistamo	ˈpie̯nˌpuhdistɑmo
pientalotontti	ˈpie̯nˌtɑloˌtontːi
pienvesi	ˈpie̯nˌʋesi
piereskeleminen	ˈpie̯reskeleminen
pietaryrtti	ˈpie̯tɑrˌyrtːi
pigmentoitua	ˈpiɡmentoi̯tuɑˣ
pihakeittiö	ˈpihɑˌkei̯tːiø
pihaparlamentti	ˈpihɑˌpɑrlɑmentːi
pihatatar	ˈpihɑˌtɑtɑr
pihisti	ˈpihisti
pihtakuusi	ˈpihtɑˌkuːsi
pihtisynnytys	ˈpihtiˌsynːytys
piikanen	ˈpiːkɑnen
piikiviase	ˈpiːˌkiʋiˌɑseˣ
piikkikorko	ˈpiːkːiˌkorko
piikkipensaikko	ˈpiːkːiˌpensɑi̯kːo
piikominen	ˈpiːkominen
piillä	ˈpiːlːæˣ
piilokonttori	ˈpiːloˌkontːori
piilonappi	ˈpiːloˌnɑpːi
piilosokkeli	ˈpiːloˌsokːeli
piilotyötön	ˈpiːloˌtyø̯tøn
piilukko	ˈpiːˌlukːo
piimävelli	ˈpiːmæˌʋelːi
piintyä	ˈpiːntyæˣ
piippolakki	ˈpiːpːoˌlɑkːi
piipunperät	ˈpiːpunˌperæt
piiranen	ˈpiːrɑnen
piirikaavio	ˈpiːriˌkɑːʋio
piirineuvosto	ˈpiːriˌneu̯ʋosto
piiritoimisto	ˈpiːriˌtoi̯misto
piirros	ˈpiːrːos
piirtoalue	ˈpiːrtoˌɑlueˣ
piirustaminen	ˈpiːrustɑminen
piirustuspöytä	ˈpiːrustusˌpøy̯tæ
piisi	ˈpiːsi
piiskaryyppy	ˈpiːskɑˌryːpːy
piispa	ˈpiːspɑ
piispatar	ˈpiːspɑtɑr
pika-asutustila	ˈpikɑˌ(ʔ)ɑsutusˌtilɑ
pikaistus	ˈpikɑi̯stus
pikakivääri	ˈpikɑˌkiʋæːri
pikaliitin	ˈpikɑˌliːtin
pikalähetys	ˈpikɑˌlæhetys
pikapano	ˈpikɑˌpɑno
pikariisi	ˈpikɑˌriːsi
pikatie	ˈpikɑˌtie̯
pikaviestipalvelu	ˈpikɑˌʋie̯stiˌpɑlʋelu
pikeäminen	ˈpikeæminen
pikinen	ˈpikinen
pikkarainen	ˈpikːɑrɑi̯nen
pikku-ukko	ˈpikːuˌ(ʔ)ukːo
pikkuhuitti	ˈpikːuˌhui̯tːi
pikkukeiju	ˈpikːuˌkei̯ju
pikkulantio	ˈpikːuˌlɑntio
pikkumaisesti	ˈpikːumɑi̯sestiˣ
pikkupakkanen	ˈpikːuˌpɑkːɑnen
pikkupuku	ˈpikːuˌpuku
pikkuriikkinen	ˈpikːuˌriːkːinen
pikkuryssä	ˈpikːuˌrysːæ
pikkusormi	ˈpikːuˌsormi
pikkutuhmasti	ˈpikːuˌtuhmɑstiˣ
pikkuvasikka	ˈpikːuˌʋɑsikːɑ
pikriinihappo	ˈpikriːniˌhɑpːo
pilaannuttaa	ˈpilɑːnːutːɑːˣ
pilailu	ˈpilɑi̯lu
pilanpäin	ˈpilɑnˌpæi̯n
pilasteri	ˈpilɑsteri
pilkallisuus	ˈpilkɑlːisuːs
pilkkaaminen	ˈpilkːɑːminen
pilkkionginta	ˈpilkːiˌoŋːintɑ
pilkkusääntö	ˈpilkːuˌsæːntø
pilkunviilaaja	ˈpilkunˌʋiːlɑːjɑ
pillerirasia	ˈpilːeriˌrɑsiɑ
pillipiipari	ˈpilːiˌpiːpɑri
piloilla	ˈpiloi̯lːɑ
pilveillä	ˈpilʋei̯lːæˣ
pilvettömyys	ˈpilʋetːømyːs
pilvipouta	ˈpilʋiˌpou̯tɑ
pilviverho	ˈpilʋiˌʋerho
pimitys	ˈpimitys
pin-up-tyttö	ˈpinˌɑpˌtytːø
pingottaminen	ˈpiŋːotːɑminen
pinkoittain	ˈpiŋkoi̯tːɑi̯n
pinnallisuus	ˈpinːɑlːisuːs
pinnemmasta	ˈpinːemːɑstɑ
pinnoite	ˈpinːoi̯teˣ
pinokuutio	ˈpinoˌkuːtio
pinsettiote	ˈpinsetːiˌoteˣ
pintakasvillisuus	ˈpintɑˌkɑsʋilːisuːs
pintakäsittelijä	ˈpintɑˌkæsitːelijæ
pintapuolisesti	ˈpintɑˌpuo̯lisestiˣ
pintavirta	ˈpintɑˌʋirtɑ
pioneerikomppania	ˈpioneːriˌkompːɑniɑ
piparkakkutaikina	ˈpipɑrˌkɑkːuˌtɑi̯kinɑ
pipo	ˈpipo
pirahtaminen	ˈpirɑhtɑminen
piripolkka	ˈpiriˌpolkːɑ
pirskahdella	ˈpirskɑhdelːɑˣ
pirssari	ˈpirsːɑri
pirteä	ˈpirteæ
pirullisesti	ˈpirulːisestiˣ
pisamanaama	ˈpisɑmɑˌnɑːmɑ
pissaliisa	ˈpisːɑˌliːsɑ
pisteellinen	ˈpisteːlːinen
pistelinko	ˈpisteˣˌliŋko
pistetuomari	ˈpisteˣˌtuo̯mɑri
pistoke	ˈpistokeˣ
pistukka	ˈpistukːɑ
pitchi	ˈpitʃi
pitkistyä	ˈpitkistyæˣ
pitkokset	ˈpitkokset
pitkäaikaisuus	ˈpitkæˌɑi̯kɑi̯suːs
pitkäjännitteisesti	ˈpitkæˌjænːitːei̯sestiˣ
pitkäkseen	ˈpitkækseːn
pitkämielinen	ˈpitkæˌmie̯linen
pitkänäköisyys	ˈpitkæˌnækøi̯syːs
pitkästyttävyys	ˈpitkæstytːæʋyːs
pitkäuninen	ˈpitkæˌuninen
pitopaikka	ˈpitoˌpɑi̯kːɑ
pitovoima	ˈpitoˌʋoi̯mɑ
pituinen	ˈpitui̯nen
pituuspiiri	ˈpituːsˌpiːri
pitämättömyys	ˈpitæmætːømyːs
pitää puhe	ˈpitæː ˈpuheˣ
piupaut	ˈpiu̯pɑut
planeettavaihteisto	ˈplɑneːtːɑˌʋɑi̯htei̯sto
plasmidi	ˈplɑsmidi
platykurtinen	ˈplɑtyˌkurtinen
pleuradreeni	ˈpleu̯rɑdreːni
plupluttaa	ˈpluplutːɑːˣ
plutokratia	ˈplutoˌkrɑtiɑ
pogostantauti	ˈpoɡostɑnˌtɑu̯ti
pohjakosketus	ˈpohjɑˌkosketus
pohjamaalaus	ˈpohjɑˌmɑːlɑus
pohjanmaalainen	ˈpohjɑnmɑːlɑi̯nen
pohjapiirustus	ˈpohjɑˌpiːrustus
pohjavoide	ˈpohjɑˌʋoi̯deˣ
pohjemmalta	ˈpohjemːɑltɑ
pohjimpana	ˈpohjimpɑnɑ
pohjoisafrikkalainen	ˈpohjoi̯sˌɑfrikːɑlɑi̯nen
pohjoismurre	ˈpohjoi̯sˌmurːeˣ
pohjoissuomenkarja	ˈpohjoi̯sˌsuo̯menˌkɑrjɑ
pohtaa	ˈpohtɑːˣ
poikakissa	ˈpoi̯kɑˌkisːɑ
poikasakki	ˈpoi̯kɑˌsɑkːi
poikkeama	ˈpoi̯kːeɑmɑ
poikkeuslahjakkuus	ˈpoi̯kːeusˌlɑhjɑkːuːs
poikkijuova	ˈpoi̯kːiˌjuo̯ʋɑ
poikkipuu	ˈpoi̯kːiˌpuː
poikkitieteellisyys	ˈpoi̯kːiˌtie̯teːlːisyːs
poimintalasta	ˈpoi̯mintɑˌlɑstɑ
poimulehti	ˈpoi̯muˌlehti
poimuvuoristo	ˈpoi̯muˌʋuo̯risto
poissa	ˈpoi̯sːɑ
poistella	ˈpoi̯stelːɑˣ
poistovoima	ˈpoi̯stoˌʋoi̯mɑ
poi’ittaminen	ˈpoi̯.itːɑminen
pokasaha	ˈpokɑˌsɑhɑ
pokkari	ˈpokːɑri
polaaripäivä	ˈpolɑːriˌpæi̯ʋæ
polaroida	ˈpolɑroi̯dɑˣ
poliisihallinto	ˈpoliːsiˌhɑlːinto
poliisilaki	ˈpoliːsiˌlɑki
poliisitarkastaja	ˈpoliːsiˌtɑrkɑstɑjɑ
poliittisluontoinen	ˈpoliːtːisˌluo̯ntoi̯nen
politisoiminen	ˈpolitisoi̯minen
poljennollisesti	ˈpoljenːolːisestiˣ
polkka	ˈpolkːɑ
polkupyörä	ˈpolkuˌpyø̯ræ
pollari	ˈpolːɑri
polskahtaa	ˈpolskɑhtɑːˣ
poltettu tiili	ˈpoltetːu ˈtiːli
polttiainen	ˈpoltːiɑi̯nen
polttokalmisto	ˈpoltːoˌkɑlmisto
polttomaalata	ˈpoltːoˌmɑːlɑtɑˣ
polttoöljy	ˈpoltːoˌøljy
polvitaklaus	ˈpolʋiˌtɑklɑus
polyesterifilmi	ˈpolyesteriˌfilmi
polymerointi	ˈpolyˌmeroi̯nti
polynomirengas	ˈpolynomiˌreŋːɑs
pommitella	ˈpomːitelːɑˣ
pomotella	ˈpomotelːɑˣ
pompottaa	ˈpompotːɑːˣ
pomppulyönti	ˈpompːuˌlyø̯nti
ponnahdus	ˈponːɑhdus
ponneaine	ˈponːeˣˌɑi̯neˣ
ponssari	ˈponsːɑri
ponttihirsi	ˈpontːiˌhirsi
pop-musiikki	ˈpopˌmusiːkːi
poppeli	ˈpopːeli
populaatiogenetiikka	ˈpopulɑːtioˌɡenetiːkːɑ
porari	ˈporɑri
poretabletti	ˈporeˣˌtɑbletːi
porilainen	ˈporilɑi̯nen
pormestari	ˈpormestɑri
pornokauppias	ˈpornoˌkɑu̯pːiɑs
porohärkä	ˈporoˌhærkæ
poromies	ˈporoˌmie̯s
poronpaisti	ˈporonˌpɑi̯sti
porosuoja	ˈporoˌsuo̯jɑ
porraselementti	ˈporːɑsˌelementːi
porrastasanne	ˈporːɑsˌtɑsɑnːeˣ
porsasmainen	ˈporsɑsˌmɑi̯nen
porskuttaa	ˈporskutːɑːˣ
portiikki	ˈportiːkːi
portugalilainen	ˈport(ː)uɡɑlilɑi̯nen
porvarisnainen	ˈporʋɑrisˌnɑi̯nen
poseeraus	ˈposeːrɑus
poskettomasti	ˈposketːomɑstiˣ
posliini	ˈposliːni
posso	ˈposːo
postfordismi	ˈpostˌfordismi
postilaitos	ˈpostiˌlɑi̯tos
postimerkkiautomaatti	ˈpostiˌmerkːiˌɑu̯tomɑːtːi
postinkanto	ˈpostinˌkɑnto
postittaminen	ˈpostitːɑminen
potaskankeitto	ˈpotɑskɑnˌkei̯tːo
potenssisarja	ˈpotensːiˌsɑrjɑ
poterni	ˈpoterni
potkaiseminen	ˈpotkɑi̯seminen
potkukelkka	ˈpotkuˌkelkːɑ
potlohko	ˈpotlohko
pottumaito	ˈpotːuˌmɑi̯to
poukata	ˈpou̯kɑtɑˣ
poutailma	ˈpou̯tɑˌilmɑ
povata	ˈpoʋɑtɑˣ
predikaatti	ˈpredikɑːtːi
prekompakti	ˈpreˌkompɑkti
presentoida	ˈpresentoi̯dɑˣ
priimuskeitin	ˈpriːmusˌkei̯tin
prinssi	ˈprinsːi
prismasauva	ˈprismɑˌsɑu̯ʋɑ
professio	ˈprofesːio
projektijohtaja	ˈprojektiˌjohtɑjɑ
prolapsi	ˈprolɑpsi
pronaatio	ˈpronɑːtio
proosateksti	ˈproːsɑˌteksti
proseduraalinen	ˈprosedurɑːlinen
prosessinjohto	ˈprosesːinˌjohto
prostituoida	ˈprostituoi̯dɑˣ
proteomi	ˈproteomi
protoni	ˈprotoni
provosoitua	ˈproʋosoi̯tuɑˣ
prötti	ˈprøtːi
psii	ˈpsiː
psykofysiologi	ˈpsykoˌfysioˌloɡi
psykopatologi	ˈpsykoˌpɑtoloɡi
publiikki	ˈpubliːkːi
pudotus	ˈpudotus
puhallin	ˈpuhɑlːin
puhalluttaminen	ˈpuhɑlːutːɑminen
puhdasmuotoinen	ˈpuhdɑsˌmuo̯toi̯nen
puhde	ˈpuhdeˣ
puhdistusmenot	ˈpuhdistusˌmenot
puheensorina	ˈpuheːnˌsorinɑ
puhekielinen	ˈpuheˣˌkie̯linen
puhelingallup	ˈpuhelinˌɡɑlːup
puhelinkysely	ˈpuhelinˌkysely
puhelinmääräys	ˈpuhelinˌmæːræys
puhelinseksi	ˈpuhelinˌseksi
puhelintoivekonsertti	ˈpuhelinˌtoi̯ʋeˣˌkonsertːi
puhelinyhteys	ˈpuhelinˌyhteys
puhenopeus	ˈpuheˣˌnopeus
puhevammainen	ˈpuheˣˌʋɑmːɑi̯nen
puhkaisu	ˈpuhkɑi̯su
puhtaaksikirjoitus	ˈpuhtɑːksiˌkirjoi̯tus
puhti	ˈpuhti
puhuminen	ˈpuhuminen
puhvelihärkä	ˈpuhʋeliˌhærkæ
puikkari	ˈpui̯kːɑri
puimuri	ˈpui̯muri
puisto	ˈpui̯sto
puiteohjelma	ˈpui̯teˣˌohjelmɑ
pujottautua	ˈpujotːɑu̯tuɑˣ
pukea	ˈpukeɑˣ
pukkari	ˈpukːɑri
puksprööti	ˈpuksprøːti
pukukaappi	ˈpukuˌkɑːpːi
pula-aika	ˈpulɑˌ(ʔ)ɑi̯kɑ
puli	ˈpuli
puliveivata	ˈpuliˌʋei̯ʋɑtɑˣ
pullamössö	ˈpulːɑˌmøsːø
pulleaposkinen	ˈpulːeɑˌposkinen
pullistelu	ˈpulːistelu
pullomaito	ˈpulːoˌmɑi̯to
pulloposkinen	ˈpulːoˌposkinen
pulmalelu	ˈpulmɑˌlelu
pulppuilla	ˈpulpːui̯lːɑˣ
pulssikoodimodulaatio	ˈpulsːiˌkoːdiˌmodulɑːtio
pulttikiinnitteinen	ˈpultːiˌkiːnːitːei̯nen
pumaska	ˈpumɑskɑ
pumppukannu	ˈpumpːuˌkɑnːu
pumpulinpehmeä	ˈpumpulinˌpehmeæ
punaharmaa	ˈpunɑˌhɑrmɑː
punailves	ˈpunɑˌilʋes
punakirjava	ˈpunɑˌkirjɑʋɑ
punakuvioinen	ˈpunɑˌkuʋioi̯nen
punalohi	ˈpunɑˌlohi
punapeippi	ˈpunɑˌpei̯pːi
punasleipä	ˈpunɑsˌlei̯pæ
punaus	ˈpunɑus
punehtuma	ˈpunehtumɑ
punkalaitumelainen	ˈpuŋkɑˌlɑi̯tumelɑi̯nen
punnita	ˈpunːitɑˣ
punontatyö	ˈpunontɑˌtyø̯
puntteli	ˈpuntːeli
puolankalainen	ˈpuo̯lɑŋkɑlɑi̯nen
puolenkymmentä	ˈpuo̯lenˌkymːentæ
puoliaavikko	ˈpuo̯liˌɑːʋikːo
puolihorroksista	ˈpuo̯liˌhorːoksistɑ
puolijulkinen	ˈpuo̯liˌjulkinen
puolikielinen	ˈpuo̯liˌkie̯linen
puolikuiva	ˈpuo̯liˌkui̯ʋɑ
puolikuva	ˈpuo̯liˌkuʋɑ
puolilähikuva	ˈpuo̯liˌlæhiˌkuʋɑ
puolinaisuus	ˈpuo̯linɑi̯suːs
puolipitoinen	ˈpuo̯liˌpitoi̯nen
puolipyörryksiin	ˈpuo̯liˌpyø̯rːyksiːn
puolireaktio	ˈpuo̯liˌreɑktio
puoliselkään	ˈpuo̯liˌselkæːn
puolisokea	ˈpuo̯liˌsokeɑ
puolisääreen	ˈpuo̯liˌsæːreːn
puolitauko	ˈpuo̯liˌtɑu̯ko
puolittaja	ˈpuo̯litːɑjɑ
puolitusmenetelmä	ˈpuo̯litusˌmenetelmæ
puolivalmiste	ˈpuo̯liˌʋɑlmisteˣ
puolivilli	ˈpuo̯liˌʋilːi
puoliväkisin	ˈpuo̯liˌʋækisin
puolueettomuusjulistus	ˈpuo̯lueːtːomuːsˌjulistus
puolueorganisaattori	ˈpuo̯lueˣˌorɡɑnisɑːtːori
puoluevirkailija	ˈpuo̯lueˣˌʋirkɑi̯lijɑ
puolustaa	ˈpuo̯lustɑːˣ
puolustushallinto	ˈpuo̯lustusˌhɑlːinto
puolustuspoliittinen	ˈpuo̯lustusˌpoliːtːinen
puomittaa	ˈpuo̯mitːɑːˣ
pupeltaa	ˈpupeltɑːˣ
purasin	ˈpurɑsin
purilainen	ˈpurilɑi̯nen
puristella	ˈpuristelːɑˣ
puristumaton	ˈpuristumɑton
puritaaninen	ˈpuritɑːninen
purjehduskuntoinen	ˈpurjehdusˌkuntoi̯nen
purjevene	ˈpurjeˣˌʋeneˣ
purkauspaikka	ˈpurkɑusˌpɑi̯kːɑ
purkinavaaja	ˈpurkinˌɑʋɑːjɑ
purnaaja	ˈpurnɑːjɑ
purppurahohteinen	ˈpurpːurɑˌhohtei̯nen
pursi	ˈpursi
purskuttaminen	ˈpurskutːɑminen
pursuhopeatäplä	ˈpursuˌhopeɑˌtæplæ
purupihka	ˈpuruˌpihkɑ
puserrella	ˈpuserːelːɑˣ
puskeutua	ˈpuskeu̯tuɑˣ
pussata	ˈpusːɑtɑˣ
pussikas	ˈpusːikɑs
pussinperä	ˈpusːinˌperæ
pussukka	ˈpusːukːɑ
putkahdella	ˈputkɑhdelːɑˣ
putkimies	ˈputkiˌmie̯s
putkittaa	ˈputkitːɑːˣ
putsata	ˈputsɑtɑˣ
puuduksiin	ˈpuːduksiːn
puuhakkuus	ˈpuːhɑkːuːs
puujauho	ˈpuːˌjɑu̯ho
puukerros	ˈpuːˌkerːos
puukottaja	ˈpuːkotːɑjɑ
puulelu	ˈpuːˌlelu
puuma	ˈpuːmɑ
puunjuuri	ˈpuːnˌjuːri
puunto	ˈpuːnto
puupora	ˈpuːˌporɑ
puuro	ˈpuːro
puurunkoinen	ˈpuːˌruŋkoi̯nen
puuskittain	ˈpuːskitːɑi̯n
puusyy	ˈpuːˌsyː
puutarhakalusto	ˈpuːˌtɑrhɑˌkɑlusto
puutarhanviljely	ˈpuːˌtɑrhɑnˌʋiljely
puutarhatyö	ˈpuːˌtɑrhɑˌtyø̯
puutiaisaivokuume	ˈpuːtiɑi̯sˌɑi̯ʋoˌkuːmeˣ
puutto	ˈpuːtːo
puutähde	ˈpuːˌtæhdeˣ
puuvillakuitu	ˈpuːˌʋilːɑˌkui̯tu
puuvillatrikoo	ˈpuːˌʋilːɑˌtrikoː
pyhisin	ˈpyhisin
pyhäilta	ˈpyhæˌiltɑ
pyhärantalainen	ˈpyhæˌrɑntɑlɑi̯nen
pykälikkö	ˈpykælikːø
pyllistellä	ˈpylːistelːæˣ
pylpyrä	ˈpylpyræ
pynttäytyä	ˈpyntːæy̯tyæˣ
pyristely	ˈpyristely
pyromorfiitti	ˈpyroˌmorfiːtːi
pyruvaldehydi	ˈpyruʋɑldehydi
pyrähdellä	ˈpyræhdelːæˣ
pystyerottelu	ˈpystyˌerotːelu
pystykorvarotu	ˈpystyˌkorʋɑˌrotu
pystynopeus	ˈpystyˌnopeus
pystyrukki	ˈpystyˌrukːi
pystysuuntainen	ˈpystyˌsuːntɑi̯nen
pystyviiva	ˈpystyˌʋiːʋɑ
pystö	ˈpystø
pysyväisosoite	ˈpysyʋæi̯sˌosoi̯teˣ
pysähtää	ˈpysæhtæːˣ
pysäköintikielto	ˈpysækøi̯ntiˌkie̯lto
pythagoralainen	ˈpytɑɡorɑlɑi̯nen
pyy	ˈpyː
pyyhiskely	ˈpyːhiskely
pyykinkuivauskaappi	ˈpyːkinˌkui̯ʋɑusˌkɑːpːi
pyykkipoika	ˈpyːkːiˌpoi̯kɑ
pyyntihinta	ˈpyːntiˌhintɑ
pyyntö	ˈpyːntø
pyytää	ˈpyːtæːˣ
pyöreäkaarinen	ˈpyø̯reæˌkɑːrinen
pyörimissuunta	ˈpyø̯rimisˌsuːntɑ
pyörittely	ˈpyø̯ritːely
pyörrytys	ˈpyø̯rːytys
pyörähdellä	ˈpyø̯ræhdelːæˣ
pyöräke	ˈpyø̯rækeˣ
pyörätuolikoripallo	ˈpyø̯ræˌtuo̯liˌkoriˌpɑlːo
pyöröharja	ˈpyø̯røˌhɑrjɑ
pyöröpaali	ˈpyø̯røˌpɑːli
pähkähullu	ˈpæhkæhulːu
päihdyksiin	ˈpæi̯hdyksiːn
päikseen	ˈpæi̯kseːn
päittäinen	ˈpæi̯tːæi̯nen
päiväjumalanpalvelus	ˈpæi̯ʋæˌjumɑlɑnˌpɑlʋelus
päivälleen	ˈpæi̯ʋælːeːn
päivänokoset	ˈpæi̯ʋæˌnokoset
päiväpalaveri	ˈpæi̯ʋæˌpɑlɑʋeri
päivätorkut	ˈpæi̯ʋæˌtorkut
päkiä	ˈpækiæ
pälvi	ˈpælʋi
pälyily	ˈpælyi̯ly
päre	ˈpæreˣ
päristellä	ˈpæristelːæˣ
pärske	ˈpærskeˣ
pärskäyttää	ˈpærskæytːæːˣ
päteminen	ˈpæteminen
pätkittäin	ˈpætkitːæi̯n
pääaihe	ˈpæːˌɑi̯heˣ
päähänpälkähdys	ˈpæːhænˌpælkæhdys
pääkansi	ˈpæːˌkɑnsi
pääkone	ˈpæːˌkoneˣ
pääliina	ˈpæːˌliːnɑ
päällekkäinen	ˈpæːlːekːæi̯nen
päällikkö	ˈpæːlːikːø
päällystakki	ˈpæːlːysˌtɑkːi
päältä	ˈpæːltæ
päämies	ˈpæːˌmie̯s
päänalunen	ˈpæːnˌɑlunen
päänmyötäinen	ˈpæːnˌmyø̯tæi̯nen
päänsilitys	ˈpæːnˌsilitys
pääomaköyhä	ˈpæːˌomɑˌkøy̯hæ
pääosa	ˈpæːˌosɑ
pääpiru	ˈpæːˌpiru
päärynäjäätelö	ˈpæːrynæˌjæːtelø
pääsiäinen	ˈpæːsiæi̯nen
pääsiäiskukko	ˈpæːsiæi̯sˌkukːo
pääsiäispöytä	ˈpæːsiæi̯sˌpøy̯tæ
päästä	ˈpæːstæˣ
päästöskenaario	ˈpæːstøˌskenɑːrio
pääsääntö	ˈpæːˌsæːntø
päätellä	ˈpæːtelːæˣ
päätoimittaja	ˈpæːˌtoi̯mitːɑjɑ
päättäjäisillanvietto	ˈpæːtːæjæi̯sˌilːɑnˌʋie̯tːo
päättää	ˈpæːtːæːˣ
päätyminen	ˈpæːtyminen
päätäntävalta	ˈpæːtæntæˌʋɑltɑ
päätösvallaton	ˈpæːtøsˌʋɑlːɑton
pöhkö	ˈpøhkø
pöhötys	ˈpøhøtys
pökät	ˈpøkæt
pölkyttää	ˈpølkytːæːˣ
pöllyäminen	ˈpølːyæminen
pölpötys	ˈpølpøtys
pölymaa	ˈpølyˌmɑː
pölyräjähdys	ˈpølyˌræjæhdys
pölyttää	ˈpølytːæːˣ
pölähtää	ˈpølæhtæːˣ
pönkittää	ˈpøŋkitːæːˣ
pöpelikkö	ˈpøpelikːø
pörhölleen	ˈpørhølːeːn
pörröhäntäinen	ˈpørːøˌhæntæi̯nen
pörrötukkainen	ˈpørːøˌtukːɑi̯nen
pösö	ˈpøsø
pöyheä	ˈpøy̯heæ
pöyhölleen	ˈpøy̯hølːeːn
pöytye	ˈpøy̯tyeˣ
pöytäkartta	ˈpøy̯tæˌkɑrtːɑ
pöytämikro	ˈpøy̯tæˌmikro
pöytäviini	ˈpøy̯tæˌʋiːni
raadella	ˈrɑːdelːɑˣ
raahauttaa	ˈrɑːhɑutːɑːˣ
raaka	ˈrɑːkɑ
raakakopio	ˈrɑːkɑˌkopio
raakamaito	ˈrɑːkɑˌmɑi̯to
raakaravinto	ˈrɑːkɑˌrɑʋinto
raakatislaus	ˈrɑːkɑˌtislɑus
raakkeli	ˈrɑːkːeli
raamatullisaiheinen	ˈrɑːmɑtulːisˌɑi̯hei̯nen
raamittaminen	ˈrɑːmitːɑminen
raapia	ˈrɑːpiɑˣ
raaputtaminen	ˈrɑːputːɑminen
raataminen	ˈrɑːtɑminen
raavin	ˈrɑːʋin
radio-	ˈrɑdio-
radiodokumentti	ˈrɑdioˌdokumentːi
radiokuuntelija	ˈrɑdioˌkuːntelijɑ
radiometrinen	ˈrɑdioˌmetrinen
radiosuuntimislaite	ˈrɑdioˌsuːntimisˌlɑi̯teˣ
raffi	ˈrɑfːi
raha	ˈrɑhɑ
raha-avustus	ˈrɑhɑˌ(ʔ)ɑʋustus
rahalahja	ˈrɑhɑˌlɑhjɑ
rahalähetys	ˈrɑhɑˌlæhetys
rahanahneus	ˈrɑhɑnˌɑhneus
rahanlähde	ˈrɑhɑnˌlæhdeˣ
rahanväärentäjä	ˈrɑhɑnˌʋæːrentæjæ
rahareikä	ˈrɑhɑˌrei̯kæ
rahastoyhtiö	ˈrɑhɑstoˌyhtiø
rahaton	ˈrɑhɑton
rahavirta	ˈrɑhɑˌʋirtɑ
rahje	ˈrɑhjeˣ
rahkoittua	ˈrɑhkoi̯tːuɑˣ
rahoitusosuus	ˈrɑhoi̯tusˌosuːs
rahtiasema	ˈrɑhtiˌɑsemɑ
rahtivapaasti	ˈrɑhtiˌʋɑpɑːstiˣ
raidoittaminen	ˈrɑi̯doi̯tːɑminen
raijata	ˈrɑi̯jɑtɑˣ
raikkaus	ˈrɑi̯kːɑus
railo	ˈrɑi̯lo
raipanisku	ˈrɑi̯pɑnˌisku
raiskaantua	ˈrɑi̯skɑːntuɑˣ
raitapuku	ˈrɑi̯tɑˌpuku
raitiotievaunu	ˈrɑi̯tioˌtie̯ˌʋɑu̯nu
raitisilmasuodatin	ˈrɑi̯tisˌilmɑˌsuo̯dɑtin
raivaaja	ˈrɑi̯ʋɑːjɑ
raivoihinsa	ˈrɑi̯ʋoi̯hinsɑˣ
raivotarjonta	ˈrɑi̯ʋoˌtɑrjontɑ
rajajoukot	ˈrɑjɑˌjou̯kot
rajakytkin	ˈrɑjɑˌkytkin
rajanhaltija	ˈrɑjɑnˌhɑltijɑ
rajataajuus	ˈrɑjɑˌtɑːjuːs
rajautua	ˈrɑjɑu̯tuɑˣ
rajoittua	ˈrɑjoi̯tːuɑˣ
rakastaa	ˈrɑkɑstɑːˣ
rakeistaa	ˈrɑkei̯stɑːˣ
rakennesuunnittelu	ˈrɑkenːeˣˌsuːnːitːelu
rakennuselementti	ˈrɑkenːusˌelementːi
rakennuskanta	ˈrɑkenːusˌkɑntɑ
rakennuskulttuuri	ˈrɑkenːusˌkultːuːri
rakennusmuovi	ˈrɑkenːusˌmuo̯ʋi
rakennuspuusepänteollisuus	ˈrɑkenːusˌpuːˌsepænˌteolːisuːs
rakennussiivooja	ˈrɑkenːusˌsiːʋoːjɑ
rakennustekniikka	ˈrɑkenːusˌtekniːkːɑ
rakennustutkimus	ˈrɑkenːusˌtutkimus
rakennusyhtiö	ˈrɑkenːusˌyhtiø
rakentava	ˈrɑkentɑʋɑ
rakentua	ˈrɑkentuɑˣ
rakkaudellisuus	ˈrɑkːɑu̯delːisuːs
rakkikoira	ˈrɑkːiˌkoi̯rɑ
rakkulainen	ˈrɑkːulɑi̯nen
rakotuli	ˈrɑkoˌtuli
raksua	ˈrɑksuɑˣ
ralliyleisö	ˈrɑlːiˌylei̯sø
rampata	ˈrɑmpɑtɑˣ
rangaistusmääräysmenettely	ˈrɑŋːɑi̯stusˌmæːræysˌmenetːely
rankasti	ˈrɑŋkɑstiˣ
rannehälytin	ˈrɑnːeˣˌhælytin
rannempana	ˈrɑnːempɑnɑ
rannikkokanava	ˈrɑnːikːoˌkɑnɑʋɑ
ranskalaismies	ˈrɑnskɑlɑi̯sˌmie̯s
ranta	ˈrɑntɑ
rantakaava	ˈrɑntɑˌkɑːʋɑ
rantakivi	ˈrɑntɑˌkiʋi
rantaloma	ˈrɑntɑˌlomɑ
rantaniitty	ˈrɑntɑˌniːtːy
rantasalmelainen	ˈrɑntɑˌsɑlmelɑi̯nen
rantavahti	ˈrɑntɑˌʋɑhti
rap-musiikki	ˈrɑpˌmusiːkːi
rapakuntoinen	ˈrɑpɑˌkuntoi̯nen
rapautuminen	ˈrɑpɑu̯tuminen
rapisuttaa	ˈrɑpisutːɑːˣ
rappeutumissairaus	ˈrɑpːeu̯tumisˌsɑi̯rɑus
rapsahtaminen	ˈrɑpsɑhtɑminen
rapsinsiemen	ˈrɑpsinˌsie̯men
rapukanta	ˈrɑpuˌkɑntɑ
rasauttaa	ˈrɑsɑutːɑːˣ
rasite	ˈrɑsiteˣ
raskas	ˈrɑskɑs
raskausarpi	ˈrɑskɑusˌɑrpi
rassaaja	ˈrɑsːɑːjɑ
rasterikuva	ˈrɑsteriˌkuʋɑ
rasvaaminen	ˈrɑsʋɑːminen
rasvakattila	ˈrɑsʋɑˌkɑtːilɑ
rasvaletti	ˈrɑsʋɑˌletːi
rasvapalo	ˈrɑsʋɑˌpɑlo
rasvasuodatin	ˈrɑsʋɑˌsuo̯dɑtin
ratamo	ˈrɑtɑmo
ratasnivel	ˈrɑtɑsˌniʋel
ratifioida	ˈrɑtifioi̯dɑˣ
ratkaista	ˈrɑtkɑi̯stɑˣ
ratkeamattomuus	ˈrɑtkeɑmɑtːomuːs
ratsastaa	ˈrɑtsɑstɑːˣ
ratsastusleiri	ˈrɑtsɑstusˌlei̯ri
ratsia	ˈrɑtsiɑ
rattilukko	ˈrɑtːiˌlukːo
raudannosto	ˈrɑu̯dɑnˌnosto
raudus	ˈrɑu̯dus
rauhanasia	ˈrɑu̯hɑnˌɑsiɑ
rauhankumppanuus	ˈrɑu̯hɑnˌkumpːɑnuːs
rauhanpuolustaja	ˈrɑu̯hɑnˌpuo̯lustɑjɑ
rauhanturvatehtävä	ˈrɑu̯hɑnˌturʋɑˌtehtæʋæ
rauhoite	ˈrɑu̯hoi̯teˣ
rauhoitusalue	ˈrɑu̯hoi̯tusˌɑlueˣ
raukki	ˈrɑu̯kːi
raunioittaa	ˈrɑu̯nioi̯tːɑːˣ
rautabakteeri	ˈrɑu̯tɑˌbɑkteːri
rautakala	ˈrɑu̯tɑˌkɑlɑ
rautalankamalli	ˈrɑu̯tɑˌlɑŋkɑˌmɑlːi
rautapaita	ˈrɑu̯tɑˌpɑi̯tɑ
rautasulatto	ˈrɑu̯tɑˌsulɑtːo
rautatieliikenne	ˈrɑu̯tɑˌtie̯ˌliːkenːeˣ
rautavalmiste	ˈrɑu̯tɑˌʋɑlmisteˣ
ravauttaa	ˈrɑʋɑutːɑːˣ
ravinnevarat	ˈrɑʋinːeˣˌʋɑrɑt
ravintoalusta	ˈrɑʋintoˌɑlustɑ
ravintolakokki	ˈrɑʋintolɑˌkokːi
ravintorasva	ˈrɑʋintoˌrɑsʋɑ
ravioli	ˈrɑʋioli
ravita	ˈrɑʋitɑˣ
ravunsakset	ˈrɑʋunˌsɑkset
reaaliaine	ˈreɑːliˌɑi̯neˣ
reaalisuus	ˈreɑːlisuːs
reaktiotapa	ˈreɑktioˌtɑpɑ
realiteetti	ˈreɑliteːtːi
refaktoroida	ˈrefɑktoroi̯dɑˣ
refleksi	ˈrefleksi
reflektori	ˈreflektori
regeneraattori	ˈreɡenerɑːtːori
rehabilitaatio	ˈreˌhɑbilitɑːtio
rehkintä	ˈrehkintæ
rehukaura	ˈrehuˌkɑu̯rɑ
rehvakka	ˈrehʋɑkːɑ
reikä	ˈrei̯kæ
reikätähtäin	ˈrei̯kæˌtæhtæi̯n
reima	ˈrei̯mɑ
reippailu	ˈrei̯pːɑi̯lu
reissuvihko	ˈrei̯sːuˌʋihko
reittikartta	ˈrei̯tːiˌkɑrtːɑ
rei’ittyä	ˈrei̯.itːyæˣ
rekiryijy	ˈrekiˌryi̯jy
rekisteröintitodistus	ˈrekisterøi̯ntiˌtodistus
reklamaatio	ˈreklɑmɑːtio
rektaskensio	ˈrekt.ɑskensio
relatiivipronomini	ˈrelɑtiːʋiˌpronomini
remahdus	ˈremɑhdus
remontoiminen	ˈremontoi̯minen
remseä	ˈremseæ
renessanssimusiikki	ˈrenesɑnsːiˌmusiːkːi
rengashotelli	ˈreŋːɑsˌhotelːi
rengaspaine	ˈreŋːɑsˌpɑi̯neˣ
rengasvalli	ˈreŋːɑsˌʋɑlːi
renqvistiläisyys	ˈrenkʋistilæi̯syːs
rentoutus	ˈrentou̯tus
repeytymä	ˈrepey̯tymæ
replikaasi	ˈreplikɑːsi
reppari	ˈrepːɑri
repro	ˈrepro
reputtaa	ˈreputːɑːˣ
resensio	ˈresensio
resignoitua	ˈresiɡnoi̯tuɑˣ
resitoiminen	ˈresitoi̯minen
respa	ˈrespɑ
resursoiminen	ˈresursoi̯minen
retinoskiisi	ˈretinoskiːsi
retkeilyvaruste	ˈretkei̯lyˌʋɑrusteˣ
retkituoli	ˈretkiˌtuo̯li
retrofleksio	ˈretroˌfleksio
retussiruisku	ˈretusːiˌrui̯sku
reuna-alue	ˈreu̯nɑˌ(ʔ)ɑlueˣ
reunapiste	ˈreu̯nɑˌpisteˣ
reunemmas	ˈreu̯nemːɑs
reunustus	ˈreu̯nustus
revisioneuvos	ˈreʋisioˌneu̯ʋos
revolverisankari	ˈreʋolʋeriˌsɑŋkɑri
reväyttää	ˈreʋæytːæːˣ
riehaantua	ˈrie̯hɑːntuɑˣ
riemastus	ˈrie̯mɑstus
riemullinen	ˈrie̯mulːinen
riepominen	ˈrie̯pominen
rietastelija	ˈrie̯tɑstelijɑ
rihla	ˈrihlɑ
riidaton	ˈriːdɑton
riihittää	ˈriːhitːæːˣ
riimisuolata	ˈriːmiˌsuo̯lɑtɑˣ
riimunvarsi	ˈriːmunˌʋɑrsi
riipalle	ˈriːpɑlːeˣ
riippukansio	ˈriːpːuˌkɑnsio
riippuvainen	ˈriːpːuʋɑi̯nen
riiputus	ˈriːputus
riisimaito	ˈriːsiˌmɑi̯to
riisiposliininen	ˈriːsiˌposliːninen
riista-aita	ˈriːstɑˌ(ʔ)ɑi̯tɑ
riisto	ˈriːsto
riisuutuminen	ˈriːsuːtuminen
riitakumppanukset	ˈriːtɑˌkumpːɑnukset
riittämättömyydentunne	ˈriːtːæmætːømyːdenˌtunːeˣ
riivatunmoinen	ˈriːʋɑtunˌmoi̯nen
rikaste	ˈrikɑsteˣ
rikka	ˈrikːɑ
rikkihappo	ˈrikːiˌhɑpːo
rikko	ˈrikːo
rikkoutuma	ˈrikːou̯tumɑ
rikollistuminen	ˈrikolːistuminen
rikoshyöty	ˈrikosˌhyø̯ty
rikosnimike	ˈrikosˌnimikeˣ
rikostuomioistuin	ˈrikosˌtuo̯mioˌistui̯n
rimanalitus	ˈrimɑnˌɑlitus
rimpsu	ˈrimpsu
rimputtelu	ˈrimputːelu
rinnakkainen	ˈrinːɑkːɑi̯nen
rinnakkaismuoto	ˈrinːɑkːɑi̯sˌmuo̯to
rinnakkaisyhteiskunta	ˈrinːɑkːɑi̯sˌyhtei̯sˌkuntɑ
rinnastua	ˈrinːɑstuɑˣ
rinovirus	ˈrinoˌʋirus
rintamakarkuruus	ˈrintɑmɑˌkɑrkuruːs
rintaproteesi	ˈrintɑˌproteːsi
rinuli	ˈrinuli
ripeäliikkeinen	ˈripeæˌliːkːei̯nen
rippikoululainen	ˈripːiˌkou̯lulɑi̯nen
ripsahdus	ˈripsɑhdus
ripsiharja	ˈripsiˌhɑrjɑ
ripsureunainen	ˈripsuˌreu̯nɑi̯nen
ripustin	ˈripustin
risatauti	ˈrisɑˌtɑu̯ti
riskikuljettaja	ˈriskiˌkuljetːɑjɑ
riskinen	ˈriskinen
riskisana	ˈriskiˌsɑnɑ
risteytymä	ˈristey̯tymæ
ristiinhäivytys	ˈristiːnˌhæi̯ʋytys
ristikantaruuvi	ˈristiˌkɑntɑˌruːʋi
ristikkorakenteinen	ˈristikːoˌrɑkentei̯nen
ristikorrelaatio	ˈristiˌkorːelɑːtio
ristinokka	ˈristiˌnokːɑ
ristipölytys	ˈristiˌpølytys
ristisaatto	ˈristiˌsɑːtːo
ristiturpa	ˈristiˌturpɑ
ristivyö	ˈristiˌʋyø̯
risutukki	ˈrisuˌtukːi
ritarilaitos	ˈritɑriˌlɑi̯tos
ritarirunous	ˈritɑriˌrunous
riuskaotteinen	ˈriu̯skɑˌotːei̯nen
rivari	ˈriʋɑri
rivijako	ˈriʋiˌjɑko
rivinylinen	ˈriʋinˌylinen
rivo	ˈriʋo
rodullistaa	ˈrodulːistɑːˣ
rohkaistua	ˈrohkɑi̯stuɑˣ
rohkia	ˈrohkiɑˣ
roikale	ˈroi̯kɑleˣ
roima	ˈroi̯mɑ
roiskauttaa	ˈroi̯skɑutːɑːˣ
rojahtaminen	ˈrojɑhtɑminen
rokastus	ˈrokɑstus
rokotus	ˈrokotus
romaanikirjallisuus	ˈromɑːniˌkirjɑlːisuːs
romahdusmaisesti	ˈromɑhdusmɑi̯sestiˣ
romanikulttuuri	ˈromɑniˌkultːuːri
rombinen	ˈrombinen
romuauto	ˈromuˌɑu̯to
romunkerääjä	ˈromunˌkeræːjæ
ronskisti	ˈronskistiˣ
roolittaja	ˈroːlitːɑjɑ
roosanvärinen	ˈroːsɑnˌʋærinen
ropsaus	ˈropsɑus
roska	ˈroskɑ
roskajoukko	ˈroskɑˌjou̯kːo
roskienkeräys	ˈroskienˌkeræys
rotaatiokone	ˈrotɑːtioˌkoneˣ
rotkelma	ˈrotkelmɑ
rottinkityö	ˈrotːiŋkiˌtyø̯
rotupuhdas	ˈrotuˌpuhdɑs
rouhia	ˈrou̯hiɑˣ
rouskua	ˈrou̯skuɑˣ
rouvamainen	ˈrou̯ʋɑˌmɑi̯nen
rubiinisormus	ˈrubiːniˌsormus
ruikuttaminen	ˈrui̯kutːɑminen
ruiskaus	ˈrui̯skɑus
ruiskulakkaus	ˈrui̯skuˌlɑkːɑus
ruisleipä	ˈrui̯sˌlei̯pæ
rujosti	ˈrujostiˣ
rukkauttaa	ˈrukːɑutːɑːˣ
rukousnauha	ˈrukousˌnɑu̯hɑ
rullakko	ˈrulːɑkːo
rullata	ˈrulːɑtɑˣ
rumeliini	ˈrumeliːni
rummunpärinä	ˈrumːunˌpærinæ
rumpumuisti	ˈrumpuˌmui̯sti
runkkaaminen	ˈruŋkːɑːminen
runkoääni	ˈruŋkoˌæːni
runokäännös	ˈrunoˌkæːnːøs
runosuoni	ˈrunoˌsuo̯ni
runsasenerginen	ˈrunsɑsˌenerɡinen
runsaslukuisesti	ˈrunsɑsˌlukui̯sestiˣ
ruoanhaju	ˈruːɑnˌhɑju
ruoansulatuselimistö	ˈruːɑnˌsulɑtusˌelimistø
ruoantähde	ˈruːɑnˌtæhdeˣ
ruohikkouistin	ˈruo̯hikːoˌui̯stin
ruoikko	ˈruo̯.ikːo
ruokailutila	ˈruo̯kɑi̯luˌtilɑ
ruokaparsa	ˈruo̯kɑˌpɑrsɑ
ruokasipuli	ˈruo̯kɑˌsipuli
ruokinta-aika	ˈruo̯kintɑˌ(ʔ)ɑi̯kɑ
ruoko	ˈruo̯ko
ruokottomuus	ˈruo̯kotːomuːs
ruoska	ˈruo̯skɑ
ruosteenpunainen	ˈruo̯steːnˌpunɑi̯nen
ruostuma	ˈruo̯stumɑ
ruotsalaisnainen	ˈruo̯tsɑlɑi̯sˌnɑi̯nen
ruotsinmaalainen	ˈruo̯tsinˌmɑːlɑi̯nen
