-άκις	ˈa.kis
-αινα	ɛ.na
-εις	is
-λλω	llo
-τατος	ta.tos
-ως	os
Αἰγαί	ɛˈɡɛ
Αἴγισθος	ˈɛ.ɡis.tʰos
Αἴθαλος	ˈɛ.tʰa.los
Αἴολος	ˈɛ.o.los
Αὐγείας	awˈɡi.as
Αὐλίς	awˈlis
Αὐτονόη	aʍ.toˈno.e
Αὔξουμον	ˈaʍk.su.mon
Βάαλ	ˈba.al
Βάλβουρα	ˈbal.bu.ra
Βέργα	ˈbɛr.ɡa
Βακτρία	bakˈtri.a
Βητριακόν	be.tri.aˈkon
Βοιωτός	by.oˈtos
Βοττιαῖοι	bot.tiˈɛ.y
Βούδειον	ˈbu.di.on
Βρέναι	ˈbrɛ.nɛ
Βραυρών	brawˈron
Βρεῦκοι	ˈbreʍ.ky
Βρυκλική	bry.kliˈke
Βυσναῖοι	byzˈnɛ.y
Βόλκων	ˈbol.kon
Βόσπορος	ˈbos.po.ros
Γαβριήλ	ɡa.briˈel
Γαθέαι	ɡaˈtʰɛ.ɛ
Γεννησαρέτ	ɡɛn.ne.saˈrɛt
Γερήνιος	ɡɛˈre.ni.os
Γηρυόνας	ɡe.ryˈo.nas
Γολγοθᾶ	ɡol.ɡoˈtʰa
Γοργίας	ɡorˈɡi.as
Γόριλλαι	ˈɡo.ril.lɛ
Δάφνη	ˈda.pʰne
Δίπαια	ˈdi.pɛ.a
Δίρφυς	ˈdir.pʰys
Δαδάκης	daˈda.kes
Δαμασκός	da.masˈkos
Δανάβη	ðaˈna.βi
Δεινόλοχος	diˈno.lo.kʰos
Δεύς	deʍs
Δημάρατος	deˈma.ra.tos
Δημοκλείδης	de.moˈkli.des
Δημόφιλος	deˈmo.pʰi.los
Δηρουσιαῖοι	de.ru.siˈɛ.y
Διονύσιος	di.oˈny.si.os
Διόσκουρος	diˈos.ku.ros
Δομίτιος	doˈmi.ti.os
Δρίλων	ˈdri.lon
Δωρίμαχος	doˈri.ma.kʰos
Εἰλείθυια	iˈli.tʰy.a
Εὐθυμένης	eʍ.tʰyˈmɛ.nes
Εὐκλῆς	eʍˈkles
Εὐρυκλῆς	ew.ryˈkles
Εὐρώπα	ewˈro.pa
Εὐχήνωρ	eʍˈkʰe.nor
Εὔμαιος	ˈew.mɛ.os
Ζάγκλη	ˈzaŋ.kle
Ζάν	zan
Ζβελθίουρδος	zbɛlˈtʰi.ur.dos
Ζελφά	zɛlˈpʰa
Ζηκᾶς	zeˈkas
Ζηνόβιος	zeˈno.bi.os
Θάρυβις	ˈtʰa.ry.bis
Θάψακος	ˈtʰap.sa.kos
Θέμις	ˈtʰɛ.mis
Θέογνις	ˈtʰɛ.o.ɡnis
Θέρμη	ˈtʰɛr.me
Θίσβη	ˈtʰiz.be
Θεσπρωτός	tʰɛs.proˈtos
Θεόφραστος	tʰɛˈo.pʰras.tos
Θηραμένης	tʰe.raˈmɛ.nes
Θουκυδίδης	tʰu.kyˈdi.des
Θρᾷξ	tʰraks
Θρῇξ	tʰreks
Κάβειροι	ˈka.bi.ry
Κάλχας	ˈkal.kʰas
Κάμειρος	ˈka.mi.ros
Κάνταβροι	ˈkan.ta.bry
Κάρβων	ˈkar.bon
Κάρουσσα	ˈka.rus.sa
Κάρπις	ˈkar.pis
Κάσταβος	ˈkas.ta.bos
Κάτων	ˈka.ton
Κάϊν	ˈka.in
Κέρκυρα	ˈkɛr.ky.ra
Κήρ	ker
Κίρκη	ˈkir.ke
Καδμηΐς	kad.meˈis
Καλπούρνιος	kalˈpur.ni.os
Κανδάκη	kanˈda.ke
Κασσάνδρα	kasˈsan.dra
Καϊάφας	ka.iˈa.pʰas
Κεγχρεαί	kɛŋ.kʰrɛˈɛ
Κηφισός	ke.pʰiˈsos
Κιμμέριος	kimˈmɛ.ri.os
Κλεάνωρ	klɛˈa.nor
Κλεοφῶν	klɛ.oˈpʰon
Κλεόμβροτος	klɛˈom.bro.tos
Κλώδιος	ˈklo.di.os
Κοπτός	kopˈtos
Κορδύβη	korˈdy.be
Κούδητος	ˈku.de.tos
Κριτόβουλος	kriˈto.bu.los
Κροσσαίη	krosˈsɛ.e
Κυδαντίδαι	ky.danˈti.dɛ
Κυδωνία	ky.doˈni.a
Κόττας	ˈkot.tas
Κύρρος	ˈkyr̥.r̥os
Κῶς	kos
Λάδων	ˈla.don
Λάκμων	ˈlak.mon
Λάρισα	ˈla.ri.sa
Λέβεδος	ˈlɛ.bɛ.dos
Λίσσος	ˈlis.sos
Λαμψακηνός	lamp.sa.keˈnos
Λασαία	laˈsɛ.a
Λεξιφάνης	lɛk.siˈpʰa.nes
Λετρῖνοι	lɛˈtri.ny
Λευκανός	leʍ.kaˈnos
Λευκοθέα	leʍ.koˈtʰɛ.a
Λεωνίδης	lɛ.oˈni.des
Λιβυρνός	li.byrˈnos
Λικιννία	li.kinˈni.a
Λιμὴν Ἀργῷος	liˈmen arˈɡo.os
Λούσιος	ˈlu.si.os
Λυκίη	lyˈki.e
Λυκαβηττός	ly.ka.betˈtos
Λύστρα	ˈlys.tra
Μάγδωλος	ˈmaɡ.do.los
Μάδυτος	ˈma.dy.tos
Μάλλιος	ˈmal.li.os
Μάρεια	ˈma.ri.a
Μάριον	ˈma.ri.on
Μέλητος	ˈmɛ.le.tos
Μέμνων	ˈmɛm.non
Μαγνησία	ma.ɡneˈsi.a
Μακαρία	ma.kaˈri.a
Μαλαώ	ma.laˈo
Μανασσῆς	ma.nasˈses
Μαντινεύς	man.tiˈneʍs
Μαράκανδα	maˈra.kan.da
Μαρμάριον	marˈma.ri.on
Μασσαλία	mas.saˈli.a
Μαχανίδας	ma.kʰaˈni.das
Μεγάλη Ἑλλάς	mɛˈɡa.le (h)ɛlˈlas
Μελίτη	mɛˈli.te
Μερόπη	mɛˈro.pe
Μεσσήνη	mɛsˈse.ne
Μεταπόντιος	mɛ.taˈpon.ti.os
Μηλιεύς	me.liˈeʍs
Μιντούρνη	minˈtur.ne
Μνεῦις	ˈmne.wis
Μορφεύς	morˈpʰeʍs
Μουνυχιών	mu.ny.kʰiˈon
Μυσία	myˈsi.a
Μύρα	ˈmy.ra
Νάγιδος	ˈna.ɡi.dos
Νάπαρις	ˈna.pa.ris
Νάρνεια	ˈnar.ni.a
Νέαρχος	ˈnɛ.ar.kʰos
Νέμεσις	ˈnɛ.mɛ.sis
Νέπως	ˈnɛ.pos
Νίκαρχος	ˈni.kar.kʰos
Ναύκρατις	ˈnaʍ.kra.tis
Νηλεύς	neˈleʍs
Νικόλαος	niˈko.la.os
Νομαντῖνος	no.manˈti.nos
Νουμέριος	nuˈmɛ.ri.os
Νῖσος	ˈni.sos
Ξόϊς	ˈkso.is
Οἰδίπους	yˈdi.pus
Οἰκλείδης	yˈkli.des
Οἰνιάδαι	y.niˈa.dɛ
Οἴαγρος	ˈy.a.ɡros
Οὐίνδιξ	uˈin.diks
Οὔαρος	ˈu.a.ros
Πάκορος	ˈpa.ko.ros
Πάνημος	ˈpa.ne.mos
Πάνορμος	ˈpa.nor.mos
Πάρμυς	ˈpar.mys
Πέλλα	ˈpɛl.la
Πέργη	ˈpɛr.ɡe
Πήληκες	ˈpe.le.kɛs
Πίερες	ˈpi.ɛ.rɛs
Παδαῖοι	paˈdɛ.y
Παλαιστίνη	pa.lɛsˈti.ne
Παλείς	paˈlis
Παλλήνη	palˈle.ne
Παναθηναϊκός	pa.na.tʰe.na.iˈkos
Παρασκευή	pa.ras.keˈwe
Παρθία	parˈtʰi.a
Πασικλῆς	pa.siˈkles
Παφλαγονία	pa.pʰla.ɡoˈni.a
Παχών	paˈkʰon
Πειρίθους	piˈri.tʰus
Πειραεύς	pi.raˈeʍs
Πελασγικός	pɛ.laz.ɡiˈkos
Πελοποννήσιος	pɛ.lo.ponˈne.si.os
Περικλύμενος	pɛ.riˈkly.mɛ.nos
Περτίναξ	pɛrˈti.naks
Πικηνός	pi.keˈnos
Πιτάνη	piˈta.ne
Πνεῦμα τὸ Ἅγιον	ˈpnew.ma to ˈ(h)a.ɡi.on
Πολυξώ	po.lykˈso
Πολύδωρος	poˈly.do.ros
Πορφυρίων	por.pʰyˈri.on
Ποτείδαια	poˈti.dɛ.a
Πρηξάσπης	prekˈsas.pes
Προκόννησος	proˈkon.ne.sos
Προῖτος	ˈpry.tos
Πυθαγορικός	py.tʰa.ɡo.riˈkos
Πόντος	ˈpon.tos
Πύλος	ˈpy.los
Σάρδεις	ˈsar.dis
Σήρ	ser
Σαιπρός	sɛˈpros
Σαλγανεύς	sal.ɡaˈneʍs
Σαλώνιος	saˈlo.ni.os
Σαμόσατα	saˈmo.sa.ta
Σαράγγαι	saˈraŋ.ɡɛ
Σατάν	saˈtan
Σελευκίδης	sɛ.leʍˈki.des
Σελινοῦς	sɛ.liˈnus
Σηκουανός	se.ku.aˈnos
Σθενώ	stʰɛˈno
Σιντός	sinˈtos
Σιρακηνοί	si.ra.keˈny
Σκίδρος	ˈski.dros
Σκυλάκη	skyˈla.ke
Σμίλα	ˈzmi.la
Σμύρνα	ˈzmyr.na
Σολοῦς	soˈlus
Σοῦδα	ˈsu.da
Στρομβιχίδης	strom.biˈkʰi.des
Στυλλάγγιον	stylˈlaŋ.ɡi.on
Στύξ	styks
Συράκουσαι	syˈra.ku.sɛ
Σωσιγένης	so.siˈɡɛ.nes
Σώζουσα	ˈso.zu.sa
Σῆστος	ˈses.tos
Σῖναι	ˈsi.nɛ
Σῦρος	ˈsy.ros
Τάναγρα	ˈta.na.ɡra
Τάρταρος	ˈtar.ta.ros
Τέμπη	ˈtɛm.pe
Τήλεφος	ˈte.lɛ.pʰos
Τίρων	ˈti.ron
Ταλθύβιος	talˈtʰy.bi.os
Ταρκύνιος	tarˈky.ni.os
Τελαμών	tɛ.laˈmon
Τελμησσός	tɛl.mesˈsos
Τερψιχόρα	tɛrp.siˈkʰo.ra
Τηρείη	teˈri.e
Τιθρώνιον	tiˈtʰro.ni.on
Τιμόθεος	tiˈmo.tʰɛ.os
Τιτανίς	ti.taˈnis
Τουσκλᾶνος	tusˈkla.nos
Τραπεζοῦς	tra.pɛˈzus
Τραϊανός	tra.i.aˈnos
Τρώγιλος	ˈtro.ɡi.los
Τρῳός	troˈos
Τυνδάρεος	tynˈda.rɛ.os
Τυράμβαι	tyˈram.bɛ
Φάρβαιθος	ˈpʰar.bɛ.tʰos
Φαβρίκιος	pʰaˈbri.ki.os
Φαιδρία	pʰɛˈdri.a
Φαιστός	pʰɛsˈtos
Φαρνάβαζος	pʰarˈna.ba.zos
Φεραί	pʰɛˈrɛ
Φιλαΐδαι	pʰi.laˈi.dɛ
Φλεγύας	pʰlɛˈɡy.as
Φλιοῦς	pʰliˈus
Φοινίκη	pʰyˈni.ke
Φρέγελλα	ˈpʰrɛ.ɡɛl.la
Φρυγία	pʰryˈɡi.a
Φυλή	pʰyˈle
Φυτία	pʰyˈti.a
Φόρκος	ˈpʰor.kos
Φῆλιξ	ˈpʰe.liks
Χάων	ˈkʰa.on
Χαβρίας	kʰaˈbri.as
Χαιρώνεια	kʰɛˈro.ni.a
Χαλάστρα	kʰaˈlas.tra
Χαναάν	kʰa.naˈan
Χαρίδημος	kʰaˈri.de.mos
Χρυσίς	kʰryˈsis
Χρόμιος	ˈkʰro.mi.os
Χόρσος	ˈkʰor.sos
Ψήσσιοι	ˈpses.si.y
Ψαμμήτιχος	psamˈme.ti.kʰos
Ψυρίη	psyˈri.e
αἰγιαλοφύλαξ	ɛ.ɡi.a.loˈpʰy.laks
αἰδέομαι	ɛˈdɛ.o.mɛ
αἰδώ	ɛˈdo
αἰσχύνω	ɛsˈkʰy.no
αἰτίζω	ɛˈti.zo
αἱρεσιώτης	(h)ɛ.rɛ.siˈo.tes
αἴθ&#039;	ɛtʰ
αἴθουσα	ˈɛ.tʰu.sa
αἴλουρος	ˈɛ.lu.ros
αἴνυμαι	ˈɛ.ny.mɛ
αἴσθησις	ˈɛs.tʰe.sis
αἶψα	ˈɛp.sa
αὐτοεπιθυμία	aʍ.to.ɛ.pi.tʰyˈmi.a
αὐτόχθων	aʍˈtokʰ.tʰon
αὖθ&#039;	aʍtʰ
αὖτ&#039;	aʍt
βάδιος	ˈba.di.os
βάλλω	ˈbal.lo
βάρβαξ	ˈbar.baks
βέβηλος	ˈbɛ.be.los
βήξ	beks
βαίνω	ˈbɛ.no
βαθύκολπος	baˈtʰy.kol.pos
βαλανεῖον	ba.laˈni.on
βαπτισμός	bap.tizˈmos
βαρύς	baˈrys
βασιλεύω	ba.siˈle.wo
βασσάρα	basˈsa.ra
βατιάκη	ba.tiˈa.ke
βαττολογία	βat.to.loˈɣi.a
βδέλλιον	ˈbdɛl.li.on
βελόνη	bɛˈlo.ne
βιβλιοθήκη	bi.bli.oˈtʰe.ke
βιζάκιον	biˈza.ki.on
βιός	biˈos
βλέπω	ˈblɛ.po
βλαβερός	bla.bɛˈros
βλαστός	blasˈtos
βλιστηρίς	blis.teˈris
βλωμός	bloˈmos
βοήθεια	boˈe.tʰi.a
βορβορυγμός	bor.bo.ryɡˈmos
βουκόρυζα	buˈko.ry.za
βουστροφηδόν	bus.tro.pʰeˈdon
βούλομαι	ˈbu.lo.mɛ
βούπρηστις	ˈbu.pres.tis
βούτυρον	ˈbu.ty.ron
βράγχος	ˈbraŋ.kʰos
βρίμη	ˈbri.me
βροτολοιγός	bro.to.lyˈɡos
βρύχημα	ˈbry.kʰe.ma
βυβλίον	byˈbli.on
βυθός	byˈtʰos
βωλίτης	boˈli.tes
βᾶρις	ˈba.ris
βῆ	be
γάλας	ˈɡa.las
γάλως	ˈɡa.los
γίγγρος	ˈɡiŋ.ɡros
γαιών	ɡɛˈon
γαληνός	ɡa.leˈnos
γαμψῶνυξ	ɡampˈso.nyks
γαστήρ	ɡasˈter
γαυσός	ɡaʍˈsos
γείτων	ˈɡi.ton
γελοῖος	ɡɛˈly.os
γενέτωρ	ɡɛˈnɛ.tor
γενεθλιακός	ɡɛ.nɛ.tʰli.aˈkos
γεράνιον	ɡɛˈra.ni.on
γερροχελώνη	ɡɛr̥.r̥o.kʰɛˈlo.ne
γλάμος	ˈɡla.mos
γλαυκῶπις	ɡlaʍˈko.pis
γλυκύς	ɡlyˈkys
γλωσσίς	ɡlosˈsis
γλῖνος	ˈɡli.nos
γνοτέρα	ɡnoˈtɛ.ra
γνωστικός	ɡnos.tiˈkos
γονής	ɡoˈnes
γράβιον	ˈɡra.bi.on
γράω	ˈɡra.o
γραμμή	ɡramˈme
γρύξ	ɡryks
γυλιός	ɡy.liˈos
γυναικωνῖτις	ɡy.nɛ.koˈni.tis
γύψινος	ˈɡyp.si.nos
δέ	dɛ
δέκατος	ˈdɛ.ka.tos
δέλφαξ	ˈdɛl.pʰaks
δέον	ˈdɛ.on
δέρκομαι	ˈdɛr.ko.mɛ
δέρω	ˈdɛ.ro
δαιτροσύνη	dɛ.troˈsy.ne
δακτυλιοθήκη	dak.ty.li.oˈtʰe.ke
δανειστής	da.nisˈtes
δαρδαίνει	darˈdɛ.ni
δασεῖα	daˈsi.a
δατέομαι	daˈtɛ.o.mɛ
δεικτικός	dik.tiˈkos
δειρή	diˈre
δενδίλλω	dɛnˈdil.lo
δηλητήρ	de.leˈter
δημοπίθηκος	de.moˈpi.tʰe.kos
διάβολος	diˈa.bo.los
διάζωμα	diˈa.zo.ma
διάλειμμα	diˈa.lim.ma
διάστασις	diˈas.ta.sis
διακονέω	di.a.koˈnɛ.o
διαλύω	di.aˈly.o
διανύω	di.aˈny.o
διαρρέω	di.ar̥ˈr̥ɛ.o
διαφανής	di.a.pʰaˈnes
διαχωρίζω	di.a.kʰoˈri.zo
διθυραμβικός	di.tʰy.ram.biˈkos
δικαιοσύνη	di.kɛ.oˈsy.ne
δικτάμνινος	dikˈtam.ni.nos
δινήεις	diˈne.is
διοικοδομέω	di.y.ko.doˈmɛ.o
διψηρός	dip.seˈros
δοάσσατο	doˈas.sa.to
δοκέω	doˈkɛ.o
δολιχός	do.liˈkʰos
δοξάζω	dokˈsa.zo
δορκάς	dorˈkas
δοτικός	do.tiˈkos
δουπέω	duˈpɛ.o
δράγμα	ˈdraɡ.ma
δρακόντιος	draˈkon.ti.os
δραστικός	dras.tiˈkos
δρόπις	ˈdro.pis
δρύοψ	ˈdry.ops
δυοκαίδεκα	dy.oˈkɛ.dɛ.ka
δυσκέλαδος	dysˈkɛ.la.dos
δυστυχία	dys.tyˈkʰi.a
δῆγμα	ˈdeɡ.ma
δῶμα	ˈdo.ma
εἰδητικός	i.de.tiˈkos
εἰκ	ik
εἰρηνάρχης	i.reˈnar.kʰes
εἰσέρχομαι	iˈsɛr.kʰo.mɛ
εἱματανωπερίβαλλος	(h)i.ma.ta.no.pɛˈri.bal.los
εἴκοσι	ˈi.ko.si
εἷος	ˈ(h)i.os
εὐαί	eˈwɛ
εὐδαίμων	ewˈdɛ.mon
εὐπαιδευσία	eʍ.pɛ.deʍˈsi.a
εὐρυπέδιλος	ew.ryˈpɛ.di.los
εὐρόνοτος	ewˈro.no.tos
εὐφρονέων	eʍ.pʰroˈnɛ.on
εὔπορος	ˈeʍ.po.ros
εὔσελμος	ˈeʍ.sɛl.mos
εὖνις	ˈew.nis
εὖτε	ˈeʍ.tɛ
ζίγγος	ˈziŋ.ɡos
ζεύγνυμι	ˈzew.ɡny.mi
ζωγάνης	zoˈɡa.nes
ζύγινος	ˈzy.ɡi.nos
ζώννυμι	ˈzon.ny.mi
ζώω	ˈzo.o
ζῴδιον	ˈzo.di.on
θάλψις	ˈtʰalp.sis
θέσις	ˈtʰɛ.sis
θέτης	ˈtʰɛ.tes
θαλασσαίγλη	tʰa.lasˈsɛ.ɡle
θαλερός	tʰa.lɛˈros
θανατηφόρος	tʰa.na.teˈpʰo.ros
θεατροκρατία	tʰɛ.a.tro.kraˈti.a
θεολόγος	tʰɛ.oˈlo.ɡos
θεοπροπέω	tʰɛ.o.proˈpɛ.o
θεωρός	tʰɛ.oˈros
θεῖος	ˈtʰi.os
θηριότης	tʰe.riˈo.tes
θολερός	tʰo.lɛˈros
θρίδαξ	ˈtʰri.daks
θραῦμα	ˈtʰraw.ma
θρόνον	ˈtʰro.non
θυρωρός	tʰy.roˈros
θύμαρνον	ˈtʰy.mar.non
θύμον	ˈtʰy.mon
θύραζε	ˈtʰy.ra.zɛ
θύω	ˈtʰy.o
θώρηξ	ˈtʰo.reks
θῆλυς	ˈtʰe.lys
θῖβις	ˈtʰi.bis
κάμμαρος	ˈkam.ma.ros
κάμψα	ˈkamp.sa
κάπετος	ˈka.pɛ.tos
κάρηνον	ˈka.re.non
κάρτος	ˈkar.tos
κάρφος	ˈkar.pʰos
κάτα	ˈka.ta
κέλης	ˈkɛ.les
κέμμορ	ˈkɛm.mor
κέρθιος	ˈkɛr.tʰi.os
κέρχνη	ˈkɛr.kʰne
κίγκλος	ˈkiŋ.klos
κίσιρνις	ˈki.sir.nis
καίριος	ˈkɛ.ri.os
καθ&#039;	katʰ
καθίστημι	kaˈtʰis.te.mi
καθαρτικός	ka.tʰar.tiˈkos
κακκάβη	kakˈka.be
κακόμοιρος	kaˈko.my.ros
κακῶς	kaˈkos
καλαμοθήκη	ka.la.moˈtʰe.ke
καλιά	ka.liˈa
καλλίθριξ	kalˈli.tʰriks
καλλιπέταλον	kal.liˈpɛ.ta.lon
κανθίαι	kanˈtʰi.ɛ
καρκίνος	karˈki.nos
κασία	kaˈsi.a
κατάγνυμι	kaˈta.ɡny.mi
κατάστεγος	kaˈtas.tɛ.ɡos
κατέπεφνον	kaˈtɛ.pɛ.pʰnon
καταλέγω	ka.taˈlɛ.ɡo
κατανάγκη	ka.taˈnaŋ.ke
καταπρακτικόν	ka.ta.prak.tiˈkon
καταφρονητικός	ka.ta.pʰro.ne.tiˈkos
καταῖτυξ	kaˈtɛ.tyks
κατηχητής	ka.te.kʰeˈtes
κατόπισθεν	kaˈto.pis.tʰɛn
καυσία	kaʍˈsi.a
καχέκτης	kaˈkʰɛk.tes
κεδρίτης	kɛˈdri.tes
κελαινός	kɛ.lɛˈnos
κεντέω	kɛnˈtɛ.o
κεραμίς	kɛ.raˈmis
κερατέα	kɛ.raˈtɛ.a
κεύθω	ˈkeʍ.tʰo
κεῖσ&#039;	kis
κηρύλος	keˈry.los
κικυμίς	ki.kyˈmis
κινέω	kiˈnɛ.o
κινύρα	kiˈny.ra
κλάδινος	ˈkla.di.nos
κλήθρινος	ˈkle.tʰri.nos
κλειτορίς	kli.toˈris
κλητός	kleˈtos
κλισίη	kliˈsi.e
κλύδων	ˈkly.don
κνίψ	knips
κνηκός	kneˈkos
κοίλωμα	ˈky.lo.ma
κοκκοθραύστης	kok.koˈtʰraʍs.tes
κολεόπτερος	ko.lɛˈop.tɛ.ros
κολυμβάς	ko.lymˈbas
κολόβιον	koˈlo.bi.on
κομόων	koˈmo.on
κονίη	koˈni.e
κοπάδιον	koˈpa.di.on
κορίαννον	koˈri.an.non
κορώνη	koˈro.ne
κοσμοπολίτας	koz.mo.poˈli.tas
κουρίς	kuˈris
κοῖος	ˈky.os
κρέμβαλα	ˈkrɛm.ba.la
κρήγυος	ˈkre.ɡy.os
κρίθινος	ˈkri.tʰi.nos
κρίνον	ˈkri.non
κραιπνός	krɛˈpnos
κρανίον	kraˈni.on
κρατερῶνυξ	kra.tɛˈro.nyks
κρατύς	kraˈtys
κρησέρα	kreˈsɛ.ra
κροκόμαγμα	kro.koˈmaɡ.ma
κρούπεζαι	ˈkru.pɛ.zɛ
κρύφα	ˈkry.pʰa
κτάομαι	ˈkta.o.mɛ
κτίσις	ˈkti.sis
κτῆνος	ˈkte.nos
κυανόπτερος	ky.aˈnop.tɛ.ros
κυβερνητικός	ky.bɛr.ne.tiˈkos
κυκεών	ky.kɛˈon
κυμινοθήκη	ky.mi.noˈtʰe.ke
κυνίδιον	kyˈni.di.on
κυνοκράμβη	ky.noˈkram.be
κυνοχάλκη	ky.nokˈkʰal.ke
κυπρῖνος	kyˈpri.nos
κωβιός	ko.biˈos
κωκύω	koˈky.o
κόγγιον	ˈkoŋ.ɡi.on
κόλος	ˈko.los
κόρος	ˈko.ros
κόρυμβος	ˈko.rym.bos
κόψα	ˈkop.sa
κύκνος	ˈky.knos
κύριθρα	ˈky.ri.tʰra
κῦμα	ˈky.ma
κῦφι	ˈky.pʰi
κῶμα	ˈko.ma
λάβρυς	ˈla.brys
λάμβδα	ˈlamb.da
λάπαθος	ˈla.pa.tʰos
λάϊνος	ˈla.i.nos
λίην	ˈli.en
λίνον	ˈli.non
λαγκία	laŋˈki.a
λαθραῖος	laˈtʰrɛ.os
λαλέω	laˈlɛ.o
λαχανοθήκη	la.kʰa.noˈtʰe.ke
λαύρα	ˈlaw.ra
λαῖφος	ˈlɛ.pʰos
λείβω	ˈli.bo
λειτουργία	li.turˈɡi.a
λεκτικός	lɛk.tiˈkos
λεπτόγεως	lɛpˈto.ɡɛ.os
λευρός	lewˈros
λιβανοθήκη	li.ba.noˈtʰe.ke
λογομαχία	lo.ɡo.maˈkʰi.a
λοιπός	lyˈpos
λορδός	lorˈdos
λυγρός	lyˈɡros
λυκόσκορδον	lyˈkos.kor.don
λυπρός	lyˈpros
λυσιμάχειον	ly.siˈma.kʰi.on
λωρυμνόν	lo.rymˈnon
λόχος	ˈlo.kʰos
λώβη	ˈlo.be
λῃστεία	lesˈti.a
λῄζομαι	ˈle.zo.mɛ
μάκιρ	ˈma.kir
μάστιξ	ˈmas.tiks
μέγαρον	ˈmɛ.ɡa.ron
μέδομαι	ˈmɛ.do.mɛ
μέθοδος	ˈmɛ.tʰo.dos
μέλαν	ˈmɛ.lan
μέλπω	ˈmɛl.po
μένω	ˈmɛ.no
μέτριος	ˈmɛ.tri.os
μήστωρ	ˈmes.tor
μίδας	ˈmi.das
μίξις	ˈmik.sis
μαθητεύω	ma.tʰeˈte.wo
μανία	maˈni.a
μασάομαι	maˈsa.o.mɛ
ματαιοτεχνία	ma.tɛ.o.tɛˈkʰni.a
μαψιδίως	map.siˈdi.os
μείλιγμα	ˈmi.liɡ.ma
μελάνουρος	mɛˈla.nu.ros
μελίμηλον	mɛˈli.me.lon
μελαγκόρυφος	mɛ.laŋˈko.ry.pʰos
μενεαίνω	mɛ.nɛˈɛ.no
μενοεικής	mɛ.no.iˈkes
μεσόλαβος	mɛˈso.la.bos
μεταβάλλω	mɛ.taˈbal.lo
μετανάστασις	mɛ.taˈnas.ta.sis
μεταφωνέω	mɛ.ta.pʰoˈnɛ.o
μετοικία	mɛ.tyˈki.a
μηδαμῶς	me.daˈmos
μηλωτρίς	me.loˈtris
μηνοειδής	me.no.iˈdes
μηχανάομαι	me.kʰaˈna.o.mɛ
μικρολογία	mi.kro.loˈɡi.a
μιμέομαι	miˈmɛ.o.mɛ
μιστύλλω	misˈtyl.lo
μνησιπήμων	mne.siˈpe.mon
μολγός	molˈɡos
μολύβδαινα	moˈlyb.dɛ.na
μονή	moˈne
μοναρχέω	mo.narˈkʰɛ.o
μυγαλέη	my.ɡaˈlɛ.e
μυθώδης	myˈtʰo.des
μυκήτινος	myˈke.ti.nos
μυριόφθαλμος	eˈwopʰ.tʰal.mos
μυροβαλάνινος	my.ro.baˈla.ni.nos
μυρσινίτης	myr.siˈni.tes
μόνωψ	ˈmo.nops
μόρον	ˈmo.ron
μόσχινος	ˈmos.kʰi.nos
μόχθος	ˈmokʰ.tʰos
μύλλος	ˈmyl.los
μύστις	ˈmys.tis
μύωψ	ˈmy.ops
μώριος	ˈmo.ri.os
μῆδος	ˈme.dos
νάρθηξ	ˈnar.tʰeks
νάφθα	ˈnapʰ.tʰa
νέομαι	ˈnɛ.o.mɛ
νή	ne
νήπιος	ˈne.pi.os
νίνον	ˈni.non
ναί	nɛ
ναῦς	naʍs
νεκρο-	nɛ.kro
νεκύδαλλος	nɛˈky.dal.los
νευρά	newˈra
νεφεληγερέτα	nɛ.pʰɛ.le.ɡɛˈrɛ.ta
νεῖκος	ˈni.kos
νησιώτης	ne.siˈo.tes
νοέω	noˈɛ.o
νομοθετικός	no.mo.tʰɛ.tiˈkos
νοσηρός	no.seˈros
νυθός	nyˈtʰos
νυμφόληπτος	nymˈpʰo.lep.tos
νυσταγμός	nys.taɡˈmos
νότινος	ˈno.ti.nos
νῶτον	ˈno.ton
νῶϊ	ˈno.i
ξένος	ˈksɛ.nos
ξανθόλευκος	ksanˈtʰo.leʍ.kos
ξενία	ksɛˈni.a
ξηνός	kseˈnos
ξυλαλόη	ksy.laˈlo.e
ξυμπλέω	ksymˈplɛ.o
ξυνειδώς	ksy.niˈdos
ξυνός	ksyˈnos
ξύλον	ˈksy.lon
ξύω	ˈksy.o
οἰκονόμος	y.koˈno.mos
οἰνοχόη	y.noˈkʰo.e
οἰσύϊνος	yˈsy.i.nos
οἰχόμενος	yˈkʰo.mɛ.nos
οἴκησις	ˈy.ke.sis
οἴμοι	ˈy.my
οἷος	ˈ(h)y.os
οὐδέτερος	uˈdɛ.tɛ.ros
οὐλαί	uˈlɛ
οὐρέω	uˈrɛ.o
οὐρανίσκος	u.raˈnis.kos
οὔτις	ˈu.tis
οὕνεκα	ˈ(h)u.nɛ.ka
οὖς	us
πάντοσε	ˈpan.to.sɛ
πάπραξ	ˈpa.praks
πάροικος	ˈpa.ry.kos
πέζις	ˈpɛ.zis
πέλεκυς	ˈpɛ.lɛ.kys
πέμφιξ	ˈpɛm.pʰiks
πέτρινος	ˈpɛ.tri.nos
πέψις	ˈpɛp.sis
πήγνυμι	ˈpe.ɡny.mi
πήρη	ˈpe.re
πίμπλημι	ˈpim.ple.mi
πίνινος	ˈpi.ni.nos
πίων	ˈpi.on
παίζω	ˈpɛ.zo
παιδίον	pɛˈdi.on
παιδαγωγία	pɛ.da.ɡoˈɡi.a
παλιούρινος	pa.liˈu.ri.nos
παμμεγέθης	pam.mɛˈɡɛ.tʰes
πανταχοῦ	pan.taˈkʰu
παράκοιτις	paˈra.ky.tis
παράφρασις	paˈra.pʰra.sis
παρέρχομαι	paˈrɛr.kʰo.mɛ
παραί	paˈrɛ
παραβολᾶνοι	pa.ra.boˈla.ny
παραδειγματικός	pa.ra.diɡ.ma.tiˈkos
παραλληλόγραμμος	pa.ral.leˈlo.ɡram.mos
παρανομία	pa.ra.noˈmi.a
παρείας	paˈri.as
παρρησία	par̥.r̥eˈsi.a
παστός	pasˈtos
πατέομαι	paˈtɛ.o.mɛ
πατριά	pa.triˈa
παῦλα	ˈpaw.la
πελωρίς	pɛ.loˈris
πεντακισχίλιοι	pɛn.ta.kisˈkʰi.li.y
πεντηκοστή	pɛn.te.kosˈte
περ	pɛr
περίζωμα	pɛˈri.zo.ma
περιβάλλω	pɛ.riˈbal.lo
περιπόρφυρος	pɛ.riˈpor.pʰy.ros
περιστροφίς	pɛ.ris.troˈpʰis
περιτυγχάνω	pɛ.ri.tyŋˈkʰa.no
περκνός	pɛrˈknos
περσέα	pɛrˈsɛ.a
πετεινός	pɛ.tiˈnos
πεῖσμα	ˈpiz.ma
πηδός	peˈdos
πισγίς	pizˈɡis
πλάθανον	ˈpla.tʰa.non
πλάσις	ˈpla.sis
πλέγμα	ˈplɛɡ.ma
πλήμνη	ˈplem.ne
πλήσμιος	ˈplez.mi.os
πλατανίστινος	pla.taˈnis.ti.nos
πλεκτάνη	plɛkˈta.ne
πλοκή	ploˈke
πλοῦτος	ˈplu.tos
πλῆγμα	ˈpleɡ.ma
πνοή	pnoˈe
ποδήνεμος	poˈde.nɛ.mos
ποιητής	py.eˈtes
ποινή	pyˈne
πολέμιος	poˈlɛ.mi.os
πολιός	po.liˈos
πολλάκι	polˈla.ki
πολυμαθής	po.ly.maˈtʰes
πολυστάφυλος	po.lysˈta.pʰy.los
πολύγαλον	poˈly.ɡa.lon
πολύφλοισβος	poˈly.pʰlyz.bos
πομπός	pomˈpos
πορεύω	poˈre.wo
πρέμνον	ˈprɛm.non
πραγματικός	praɡ.ma.tiˈkos
πραπίς	praˈpis
προέχω	proˈɛ.kʰo
προβαίνω	proˈbɛ.no
προγραφή	pro.ɡraˈpʰe
προοράω	pro.oˈra.o
προσέχω	proˈsɛ.kʰo
προσδοκάω	proz.doˈka.o
προσκήνιον	prosˈke.ni.on
προσφωνέω	pros.pʰoˈnɛ.o
προτί	proˈti
προφητίζω	pro.pʰeˈti.zo
πρωταύλης	proˈtaw.les
πρωτότοκος	proˈto.to.kos
πρόπομα	ˈpro.po.ma
πρύτανις	ˈpry.ta.nis
πρῖνος	ˈpri.nos
πτέρνη	ˈptɛr.ne
πτισάνη	ptiˈsa.ne
πτύγξ	ptyŋks
πτώξ	ptoks
πυκνός	pyˈknos
πυρή	pyˈre
πυραμοῦς	py.raˈmus
πυρσός	pyrˈsos
πόθος	ˈpo.tʰos
πόρνος	ˈpor.nos
πόσις	ˈpo.sis
πότμος	ˈpot.mos
πύανος	ˈpy.a.nos
πύξος	ˈpyk.sos
πώλης	ˈpo.les
πῶυ	ˈpo.y
σάκτας	ˈsak.tas
σάννας	ˈsan.nas
σάπιθος	ˈsa.pi.tʰos
σάρξ	sarks
σάτρα	ˈsa.tra
σέβας	ˈsɛ.bas
σέβομαι	ˈsɛ.bo.mɛ
σέσυφος	ˈsɛ.sy.pʰos
σίδαρος	ˈsi.da.ros
σίζω	ˈsi.zo
σίκυος	ˈsi.ky.os
σίλουρος	ˈsi.lu.ros
σίσαρον	ˈsi.sa.ron
σαγάπηνον	saˈɡa.pe.non
σανδαλοθήκη	san.da.loˈtʰe.ke
σαρκοκήλη	sar.koˈke.le
σατυρίσκος	sa.tyˈris.kos
σαυροκτόνος	saw.rokˈto.nos
σείσων	ˈsi.son
σεμνός	sɛmˈnos
σεργοί	sɛrˈɡy
σημειόω	se.miˈo
σιγή	siˈɡe
σιδηρουργός	si.de.rurˈɡos
σιτίον	siˈti.on
σιτώνιον	siˈto.ni.on
σιωπῇ	si.oˈpe
σκάρος	ˈska.ros
σκαλίς	skaˈlis
σκανδαλίζω	skan.daˈli.zo
σκελετός	skɛ.lɛˈtos
σκευάζω	skeˈwa.zo
σκιά	skiˈa
σκιόεις	skiˈo.is
σκοίκιον	ˈsky.ki.on
σκοπιή	sko.piˈe
σκόλυθρον	ˈsko.ly.tʰron
σκότος	ˈsko.tos
σκῦρος	ˈsky.ros
σκῶλος	ˈsko.los
σμάω	ˈzma.o
σολῖνος	soˈli.nos
σοφισμός	so.pʰizˈmos
σούσινος	ˈsu.si.nos
σπάρτινος	ˈspar.ti.nos
σπίνδαλος	ˈspin.da.los
σπαθηφόρος	spa.tʰeˈpʰo.ros
σπαργάνιον	sparˈɡa.ni.on
σπειραία	spiˈrɛ.a
σπεύδω	ˈspew.do
σποδός	spoˈdos
σπόρος	ˈspo.ros
στέγη	ˈstɛ.ɡe
στίλβω	ˈstil.bo
στασιάρχης	sta.siˈar.kʰes
σταφυλάγρα	sta.pʰyˈla.ɡra
σταῖς	stɛs
στελεά	stɛ.lɛˈa
στενόω	stɛˈno.o
στοά	stoˈa
στοιχειόω	sty.kʰiˈo.o
στοχάζομαι	stoˈkʰa.zo.mɛ
στοῖχος	ˈsty.kʰos
στρίξ	striks
στραγγουρία	straŋ.ɡuˈri.a
στρατηγία	stra.teˈɡi.a
στρατόπεδον	straˈto.pɛ.don
στροφάλιγξ	stroˈpʰa.liŋks
στρῶμα	ˈstro.ma
στύφω	ˈsty.pʰo
στῆριγξ	ˈste.riŋks
συγγραφεύς	syŋ.ɡraˈpʰeʍs
συγκοπή	syŋ.koˈpe
συκοφαντία	sy.ko.pʰanˈti.a
συλλέγω	sylˈlɛ.ɡo
συμβαίνω	symˈbɛ.no
συμμαχέω	sym.maˈkʰɛ.o
συμπαράταξις	sym.paˈra.tak.sis
συμπότης	symˈpo.tes
συναίρεσις	syˈnɛ.rɛ.sis
συναφής	sy.naˈpʰes
συνεξέρχομαι	sy.nɛkˈsɛr.kʰo.mɛ
συνοικίζω	sy.nyˈki.zo
συντέλεια	synˈtɛ.li.a
συστέλλω	sysˈtɛl.lo
σφάγνος	ˈspʰa.ɡnos
σφαλερός	spʰa.lɛˈros
σφιγκτῶς	spʰiŋkˈtos
σφύζω	ˈspʰy.zo
σχέμα	ˈskʰɛ.ma
σχαλίς	skʰaˈlis
σχῖνος	ˈskʰi.nos
σύβας	ˈsy.bas
σύμφυσις	ˈsym.pʰy.sis
σύνθεσις	ˈsyn.tʰɛ.sis
σύϊνος	ˈsy.i.nos
σῶμα	ˈso.ma
σῶτρον	ˈso.tron
τάξις	ˈtak.sis
τάχ&#039;	takʰ
τέ	tɛ
τέραμνον	ˈtɛ.ram.non
τέτριξ	ˈtɛ.triks
τήθυον	ˈte.tʰy.on
τί πράσσεις	ti ˈpras.sis
ταγήν	taˈɡen
ταράσσω	taˈras.so
ταῦρος	ˈtaw.ros
τείνω	ˈti.no
τειχοφύλαξ	ti.kʰoˈpʰy.laks
τελευταῖος	tɛ.leʍˈtɛ.os
τερμίνθινος	tɛrˈmin.tʰi.nos
τετανός	tɛ.taˈnos
τετράκυκλος	tɛˈtra.ky.klos
τευτάζω	teʍˈta.zo
τεχνογράφος	tɛ.kʰnoˈɡra.pʰos
τημελέω	te.mɛˈlɛ.o
τλήμων	ˈtle.mon
τοι	ty
τομός	toˈmos
τοπικός	to.piˈkos
τράχηλος	ˈtra.kʰe.los
τρέπω	ˈtrɛ.po
τρίαινα	ˈtri.ɛ.na
τρίβολος	ˈtri.bo.los
τρίσμακαρ	ˈtriz.ma.kar
τρίφυλλον	ˈtri.pʰyl.lon
τραγέλαφος	traˈɡɛ.la.pʰos
τρικλίνιον	triˈkli.ni.on
τριόδους	triˈo.dus
τροφικός	tro.pʰiˈkos
τροχός	troˈkʰos
τρόμος	ˈtro.mos
τρῦσις	ˈtry.sis
τυκάνη	tyˈka.ne
τόλμα	ˈtol.ma
τόρνος	ˈtor.nos
τόσσος	ˈtos.sos
τύρινος	ˈty.ri.nos
τύρρις	ˈtyr̥.r̥is
τὠυτό	toˈto
τῖλος	ˈti.los
τῦφος	ˈty.pʰos
τῶ	to
υἱωνός	(h)y.oˈnos
φάλλαινα	ˈpʰal.lɛ.na
φάρσος	ˈpʰar.sos
φέρνιον	ˈpʰɛr.ni.on
φανός	pʰaˈnos
φαρκίς	pʰarˈkis
φαῦλος	ˈpʰaw.los
φεῖ	pʰi
φθίνα	ˈpʰtʰi.na
φθαρτός	pʰtʰarˈtos
φθόνος	ˈpʰtʰo.nos
φιλήρετμος	pʰiˈle.rɛt.mos
φιλοδοξία	pʰi.lo.dokˈsi.a
φιλόξενος	pʰiˈlok.sɛ.nos
φιλότης	pʰiˈlo.tes
φλύκταινα	ˈpʰlyk.tɛ.na
φοιτάω	pʰyˈta.o
φοξῖνος	pʰokˈsi.nos
φοῦ	pʰu
φραδής	pʰraˈdes
φρόνησις	ˈpʰro.ne.sis
φυή	pʰyˈe
φυσητήρ	pʰy.seˈter
φωνή	pʰoˈne
φῶς	pʰos
χάλιξ	ˈkʰa.liks
χάραγμα	ˈkʰa.raɡ.ma
χέω	ˈkʰɛ.o
χήρα	ˈkʰe.ra
χαλκήρης	kʰalˈke.res
χαλκός	kʰalˈkos
χαμαί	kʰaˈmɛ
χαμαιλεύκη	kʰa.mɛˈleʍ.ke
χαμαιπλάτανος	kʰa.mɛˈpla.ta.nos
χαρτοθήκη	kʰar.toˈtʰe.ke
χείμαστρον	ˈkʰi.mas.tron
χειρόνιπτρον	kʰiˈro.nip.tron
χελιδών	kʰɛ.liˈdon
χερμάς	kʰɛrˈmas
χιμαιροφύλαξ	kʰi.mɛ.roˈpʰy.laks
χλαμύς	kʰlaˈmys
χλωρός	kʰloˈros
χολή	kʰoˈle
χοραύλης	kʰoˈraw.les
χοϊκός	kʰo.iˈkos
χράομαι	ˈkʰra.o.mɛ
χρέος	ˈkʰrɛ.os
χρηστότης	kʰresˈto.tes
χρυσολάχανον	kʰry.soˈla.kʰa.non
χρυσοφύλαξ	kʰry.soˈpʰy.laks
χυλός	kʰyˈlos
χυτρόπους	kʰyˈtro.pus
χωρογράφος	kʰo.roˈɡra.pʰos
ψάλμα	ˈpsal.ma
ψαιδρά	psɛˈdra
ψαύριος	ˈpsaw.ri.os
ψελλός	psɛlˈlos
ψευδογράφος	psew.doˈɡra.pʰos
ψευδώνυμος	psewˈdo.ny.mos
ψυχρός	psyˈkʰros
ψόλος	ˈpso.los
ϝαῦ	aw
ἀβυρτάκη	a.byrˈta.ke
ἀγάπη	aˈɡa.pe
ἀγαθός	a.ɡaˈtʰos
ἀγγοθήκη	aŋ.ɡoˈtʰe.ke
ἀγενεαλόγητος	a.ɡɛ.nɛ.aˈlo.ɡe.tos
ἀγκών	aŋˈkon
ἀγνώς	aˈɡnos
ἀγορή	a.ɡoˈre
ἀγριοκινάρα	a.ɡri.o.kiˈna.ra
ἀγχιστεία	aŋ.kʰisˈti.a
ἀγωνία	a.ɡoˈni.a
ἀδάρκη	aˈdar.ke
ἀδέσποτος	aˈdɛs.po.tos
ἀδιάβατος	a.diˈa.ba.os
ἀεργός	a.ɛrˈɡos
ἀκαλήφη	a.kaˈle.pʰe
ἀκατασκεύαστος	a.ka.tasˈke.was.tos
ἀκιδνός	a.kiˈdnos
ἀκραής	a.kraˈes
ἀκροβάτης	a.kroˈba.tes
ἀλάβης	aˈla.bes
ἀλάομαι	aˈla.o.mɛ
ἀλεξιφάρμακον	a.lɛk.siˈpʰar.ma.kon
ἀληθείη	a.leˈtʰi.e
ἀλλήλων	alˈle.lon
ἀλφάδιον	alˈpʰa.di.on
ἀλώπηξ	aˈlo.peks
ἀμάνδαλος	aˈman.da.los
ἀμέργω	aˈmɛr.ɡo
ἀμβλύς	amˈblys
ἀμοιβή	a.myˈbe
ἀμπελόπρασον	am.pɛˈlo.pra.son
ἀμφιβάλλω	am.pʰiˈbal.lo
ἀμφιπένομαι	am.pʰiˈpɛ.no.mɛ
ἀμόργινος	aˈmor.ɡi.nos
ἀμύγδαλον	aˈmyɡ.da.lon
ἀμύνω	aˈmy.no
ἀνάβρωσις	aˈna.bro.sis
ἀνάγω	aˈna.ɡo
ἀνάταξις	aˈna.tak.sis
ἀνίκητος	aˈni.ke.tos
ἀναΐσσω	a.naˈis.so
ἀναλγησία	a.nal.ɡeˈsi.a
ἀναμιμνήσκω	a.na.mimˈnes.ko
ἀνασκευάζω	a.nas.keˈwa.zo
ἀνδρεῖος	anˈdri.os
ἀνθέω	anˈtʰɛ.o
ἀνθρωπόλογος	an.tʰroˈpo.lo.ɡos
ἀνθόλοψ	anˈtʰo.lops
ἀνορούω	a.noˈru.o
ἀντίβιος	anˈti.bi.os
ἀντίθετον	anˈti.tʰɛ.ton
ἀντίρρινον	anˈtir̥.r̥i.non
ἀξιοπρεπής	ak.si.o.prɛˈpes
ἀορτήρ	a.orˈter
ἀπάνευθεν	aˈpa.neʍ.tʰɛn
ἀπειρία	a.piˈri.a
ἀπερείσιος	a.pɛˈri.si.os
ἀποβασιλεύς	a.po.ba.siˈleʍs
ἀποικία	a.pyˈki.a
ἀποκόπτω	a.poˈkop.to
ἀποπλέω	a.poˈplɛ.o
ἀπορέω	a.poˈrɛ.o
ἀποστολή	a.pos.toˈle
ἀποχωρέω	a.po.kʰoˈrɛ.o
ἀπόδρασις	aˈpo.dra.sis
ἀπόλλυμι	aˈpol.ly.mi
ἀπόμακτρον	aˈpo.mak.tron
ἀπών	aˈpon
ἀράσσω	aˈras.so
ἀρβάλη	arˈba.le
ἀργυροῦς	ar.ɡyˈrus
ἀργύριον	arˈɡy.ri.on
ἀργᾶς	arˈɡas
ἀρηΐφιλος	a.reˈi.pʰi.los
ἀριθμέω	a.ritʰˈmɛ.o
ἀριστεύς	a.risˈteʍs
ἀρκέω	arˈkɛ.o
ἀρυβαλλίς	a.ry.balˈlis
ἀρχάγγελος	arˈkʰaŋ.ɡɛ.los
ἀρχιραβδοῦχος	ar.kʰi.rabˈdu.kʰos
ἀρόω	aˈro.o
ἀσθενέω	as.tʰɛˈnɛ.o
ἀσκάντης	asˈkan.tes
ἀσπίς	asˈpis
ἀστραπή	as.traˈpe
ἀστυγείτων	as.tyˈɡi.ton
ἀσφαλῶς	as.pʰaˈlos
ἀσύνδετος	aˈsyn.dɛ.tos
ἀσώδης	aˈso.des
ἀτάλλω	a.tal.lo
ἀτάσθαλος	aˈtas.tʰa.los
ἀτράφαξυς	aˈtra.pʰak.sys
ἀφαιρέω	a.pʰɛˈrɛ.o
ἀφορίζω	a.pʰoˈri.zo
ἀφροσύνη	a.pʰroˈsy.ne
ἀχάτης	aˈkʰa.tes
ἀχλύς	aˈkʰlys
ἀχρεῖος	aˈkʰri.os
ἀψίνθιον	apˈsin.tʰi.on
ἁβροδίαιτος	(h)a.broˈdi.ɛ.tos
ἁγνισμός	(h)a.ɡnizˈmos
ἁδινός	(h)a.diˈnos
ἁλιπόρφυρος	(h)a.liˈpor.pʰy.ros
ἁλμυρός	(h)al.myˈros
ἁμαρτάνει	(h)a.marˈta.ni
ἄαπτος	ˈa.ap.tos
ἄβατος	ˈa.ba.tos
ἄγαμαι	ˈa.ɡa.mɛ
ἄγραφος	ˈa.ɡra.pʰos
ἄεθλον	ˈa.ɛ.tʰlon
ἄκανθος	ˈa.kan.tʰos
ἄκολος	ˈa.ko.los
ἄκορος	ˈa.ko.ros
ἄκριθος	ˈa.kri.tʰos
ἄλαστος	ˈa.las.tos
ἄλγημα	ˈal.ɡe.ma
ἄλειφαρ	ˈa.li.pʰar
ἄλλος	ˈal.los
ἄμβων	ˈam.bon
ἄν	an
ἄναρθρος	ˈa.nar.tʰros
ἄνεῳ	ˈa.nɛ.o
ἄνοδος	ˈa.no.dos
ἄνωθεν	ˈa.no.tʰɛn
ἄξων	ˈak.son
ἄπληστος	ˈa.ples.tos
ἄραβος	ˈa.ra.bos
ἄρειος	ˈa.ri.os
ἄρμενον	ˈar.mɛ.non
ἄρρωστος	ˈar̥.r̥os.tos
ἄρσην	ˈar.sen
ἄρτος	ˈar.tos
ἄσκιος	ˈas.ki.os
ἄσκοπος	ˈas.ko.pos
ἄτη	ˈa.te
ἄφθιτος	ˈapʰ.tʰi.tos
ἅμιλλα	ˈ(h)a.mil.la
ἅρμα	ˈ(h)ar.ma
ἆθλον	ˈa.tʰlon
Ἀβιά	a.biˈa
Ἀγησίλαος	a.ɡeˈsi.la.os
Ἀγριππίνη	a.ɡripˈpi.ne
Ἀδούσιος	aˈdu.si.os
Ἀδρυάς	a.dryˈas
Ἀηνόβαρβος	a.eˈno.bar.bos
Ἀθήνησιν	aˈtʰe.ne.sin
Ἀθηνᾶ	a.tʰeˈna
Ἀκταίων	akˈtɛ.on
Ἀκύλιος	aˈky.li.os
Ἀλκαμένης	al.kaˈmɛ.nes
Ἀλκμήνη	alkˈme.ne
Ἀλυάττης	a.lyˈat.tes
Ἀμαζών	a.maˈzon
Ἀμφιθόη	am.pʰiˈtʰo.e
Ἀνάφη	aˈna.pʰe
Ἀναξιμένης	a.nak.siˈmɛ.nes
Ἀνδανία	an.daˈni.a
Ἀντίνοος	anˈti.no.os
Ἀντίπας	anˈti.pas
Ἀντικύθηρα	an.tiˈky.tʰe.ra
Ἀντρών	anˈtron
Ἀπατούρια	a.paˈtu.ri.a
Ἀπιδανός	a.pi.daˈnos
Ἀπουλήϊος	a.puˈle.i.os
Ἀρίσβη	aˈriz.be
Ἀραμαῖοι	a.raˈmɛ.y
Ἀργίμπασα	arˈɡim.pa.sa
Ἀριαβίγνης	a.ri.aˈbi.ɡnes
Ἀριστόμαχος	a.risˈto.ma.kʰos
Ἀριστώνυμος	a.risˈto.ny.mos
Ἀρτεμίσιον	ar.tɛˈmi.si.on
Ἀρχέλαος	arˈkʰɛ.la.os
Ἀρχίδαμος	arˈkʰi.da.mos
Ἀσέα	aˈsɛ.a
Ἀσσυρία	as.syˈri.a
Ἀστέριον	asˈtɛ.ri.on
Ἀτλαντίς	a.tlanˈtis
Ἀττικός	at.tiˈkos
Ἀχαΐα	a.kʰaˈi.a
Ἁθύρ	(h)a.tʰyr
Ἁλικύαι	(h)a.liˈky.ɛ
Ἄγβαλος	ˈaɡ.ba.los
Ἄλος	ˈa.los
Ἄμασις	ˈa.ma.sis
Ἄμμων	ˈam.mon
Ἄνδρος	ˈan.dros
Ἄντιφος	ˈan.ti.pʰos
Ἄρνη	ˈar.ne
Ἄρποι	ˈar.py
Ἄσιος	ˈa.si.os
Ἄτροπος	ˈa.tro.pos
ἐγγυθήκη	ɛŋ.ɡyˈtʰe.ke
ἐγκράτεια	ɛŋˈkra.ti.a
ἐεικοστός	ɛ.i.kosˈtos
ἐκεῖ	ɛˈki
ἐκπορεύω	ɛk.poˈre.wo
ἐλάτινος	ɛˈla.ti.nos
ἐλευθερόψυχος	ɛ.leʍ.tʰɛˈrop.sy.kʰos
ἐλεός	ɛ.lɛˈos
ἐλλός	ɛlˈlos
ἐμμένω	ɛmˈmɛ.no
ἐμποιέω	ɛm.pyˈɛ.o
ἐμπυρισμός	ɛm.py.rizˈmos
ἐναντίον	ɛ.nanˈti.on
ἐνδελεχής	ɛn.dɛ.lɛˈkʰes
ἐνδύνω	ɛnˈdy.no
ἐνθάδε	ɛnˈtʰa.dɛ
ἐνθρόνιος	ɛnˈtʰro.ni.os
ἐντέλλω	ɛnˈtɛl.lo
ἐντός	ɛnˈtos
ἐνύπνιος	ɛˈny.pni.os
ἐξάπτω	ɛkˈsap.to
ἐξεναρίζω	ɛk.sɛ.naˈri.zo
ἐξομολογητικός	ɛk.so.mo.lo.ɡe.tiˈkos
ἐπάγω	ɛˈpa.ɡo
ἐπίμαχος	ɛˈpi.ma.kʰos
ἐπεντίθημι	ɛ.pɛnˈti.tʰe.mi
ἐπιβαίνω	ɛ.piˈbɛ.no
ἐπιγλωσσίς	ɛ.pi.ɡlosˈsis
ἐπιεικής	ɛ.pi.iˈkes
ἐπικαλέω	ɛ.pi.kaˈlɛ.o
ἐπικρατέω	ɛ.pi.kraˈtɛ.o
ἐπιμίξ	ɛ.piˈmiks
ἐπιρρέπω	ɛ.pir̥ˈr̥ɛ.po
ἐπιστέλλω	ɛ.pisˈtɛl.lo
ἐπιτήδευμα	ɛ.piˈte.dew.ma
ἐπιφορά	ɛ.pi.pʰoˈra
ἐποχή	ɛ.poˈkʰe
ἐπώνυμον	ɛˈpo.ny.mon
ἐρέτης	ɛˈrɛ.tes
ἐργαστήρ	ɛr.ɡasˈter
ἐρεείνω	ɛ.rɛˈi.no
ἐρικυδής	ɛ.ri.kyˈdes
ἐρύκω	ɛˈry.ko
ἐρώμενος	ɛˈro.mɛ.nos
ἐρῆμος	ɛˈre.mos
ἐσθίω	ɛsˈtʰi.o
ἐσχαρεῖον	ɛs.kʰaˈri.on
ἐτώσιος	ɛˈto.si.os
ἐφάλλομαι	ɛˈpʰal.lo.mɛ
ἐφευρίσκω	ɛ.pʰewˈris.ko
ἐχινόπους	ɛ.kʰiˈno.pus
ἐϋεργής	ɛ.y.ɛrˈɡes
ἑβδομηκοντακαιεκατονταπλασίων	(h)ɛb.do.me.kon.ta.kɛ.ɛ.ka.ton.ta.plaˈsi.on
ἑκκαιδέκατος	(h)ɛk.kɛˈdɛ.ka.tos
ἑλεδώνη	(h)ɛ.lɛˈdo.ne
ἑξηκοντάμοιρος	(h)ɛk.se.konˈta.my.ros
ἑταίρα	(h)ɛˈtɛ.ra
ἑτεραλκής	(h)ɛ.tɛ.ralˈkes
ἑτερώνυμος	(h)ɛ.tɛˈro.ny.mos
ἑτοῖμος	(h)ɛˈty.mos
ἒ ψιλόν	ɛ psiˈlon
ἔβρος	ˈɛ.bros
ἔγκαυμα	ˈɛŋ.kaw.ma
ἔγχελυς	ˈɛŋ.kʰɛ.lys
ἔθω	ˈɛ.tʰo
ἔκγονος	ˈɛɡ.ɡo.nos
ἔκπαγλος	ˈɛk.pa.ɡlos
ἔκτασις	ˈɛk.ta.sis
ἔλαιον	ˈɛ.lɛ.on
ἔλυμος	ˈɛ.ly.mos
ἔμβρυον	ˈɛm.bry.on
ἔμπειρος	ˈɛm.pi.ros
ἔνστασις	ˈɛns.ta.sis
ἔπειθ&#039;	ˈɛ.pitʰ
ἔπεφνον	ˈɛ.pɛ.pʰnon
ἔριφος	ˈɛ.ri.pʰos
ἔρος	ˈɛ.ros
ἔρυσος	ˈɛ.ry.sos
ἕκτος	ˈ(h)ɛk.tos
ἕο	ˈ(h)ɛ.o
ἕπομαι	ˈ(h)ɛ.po.mɛ
ἕσπερος	ˈ(h)ɛs.pɛ.ros
Ἐλεφήνωρ	ɛ.lɛˈpʰe.nor
Ἐλπίς	ɛlˈpis
Ἐξαίνετος	ɛkˈsɛ.nɛ.tos
Ἐπίδαμνος	ɛˈpi.dam.nos
Ἐρατοκλείδης	ɛ.ra.toˈkli.des
Ἐρυθρὰ θάλασσα	ɛ.ryˈtʰra ˈtʰa.las.sa
Ἐφιάλτης	ɛ.pʰiˈal.tes
Ἐφραίμ	ɛˈpʰrɛm
Ἐχέμβροτος	ɛˈkʰɛm.bro.tos
Ἑκάβη	(h)ɛˈka.be
Ἑκάτη	(h)ɛˈka.te
Ἑλβίδιος	elˈβi.ði.os
Ἑλκέθιον	(h)ɛlˈkɛ.tʰi.on
Ἑρμογένης	(h)ɛr.moˈɡɛ.nes
Ἔδεσσα	ˈɛ.dɛs.sa
Ἔννα	ˈɛn.na
Ἕλλη	ˈ(h)ɛl.le
ἠΰς	eˈys
ἠγάθεος	eˈɡa.tʰɛ.os
ἠθέω	eˈtʰɛ.o
ἠλυγαῖος	e.lyˈɡɛ.os
ἠπίολος	eˈpi.o.los
ἡλιάζομαι	(h)e.liˈa.zo.mɛ
ἡλιομαντεία	(h)e.li.o.manˈti.a
ἡμέρα	(h)eˈmɛ.ra
ἡμικρανία	(h)e.mi.kraˈni.a
ἡμιτάλαντον	(h)e.miˈta.lan.ton
ἡσυχαστής	(h)e.sy.kʰasˈtes
ἤθω	ˈe.tʰo
ἤνυστρον	ˈe.nys.tron
ἥρως	ˈ(h)e.ros
ἧδος	ˈ(h)e.dos
Ἠδωνός	e.doˈnos
Ἠχώ	eˈkʰo
Ἡγησιπύλη	(h)e.ɡe.siˈpy.le
Ἡρακλεώτης	(h)e.ra.klɛˈo.tes
Ἡρόστρατος	(h)eˈros.tra.tos
ἰάχω	iˈa.kʰo
ἰδέα	iˈdɛ.a
ἰδίωμα	iˈdi.o.ma
ἰοειδής	i.o.iˈdes
ἰσχίον	isˈkʰi.on
ἰσόψηφος	iˈsop.se.pʰos
ἰχθυάω	ikʰ.tʰyˈa.o
ἱέραξ	(h)iˈɛ.raks
ἱδρόω	(h)iˈdro.o
ἱερόμυρτος	(h)i.ɛˈro.myr.tos
ἱκετεία	(h)i.kɛˈti.a
ἱμάτιον	(h)iˈma.ti.on
ἱπποπρόσωπος	(h)ip.poˈpro.so.pos
ἱππόδρομος	(h)ipˈpo.dro.mos
ἱππόκρημνος	(h)ipˈpo.krem.nos
ἱππόφλομος	(h)ipˈpo.pʰlo.mos
ἱρός	(h)iˈros
ἱστορικός	(h)is.to.riˈkos
ἴασις	ˈi.a.sis
ἴγδις	ˈiɡ.dis
ἴκρια	ˈi.kri.a
ἴλαρχος	ˈi.lar.kʰos
ἴνδουρος	ˈin.du.ros
ἴχνος	ˈi.kʰnos
ἵημι	ˈ(h)i.e.mi
ἵν&#039;	(h)in
ἶλιγξ	ˈi.liŋks
ἶπος	ˈi.pos
Ἰάλμενος	iˈal.mɛ.nos
Ἰαβε Ζεβυθ	i.a.bɛ zɛ.bytʰ
Ἰαξαμάται	i.ak.saˈma.tɛ
Ἰθωμήτης	i.tʰoˈme.tes
Ἰλλυριός	il.ly.riˈos
Ἰνωποφύλαξ	i.no.poˈpʰy.laks
Ἰουδαϊκῶς	i.u.da.iˈkos
Ἰούνιος	iˈu.ni.os
Ἰσμαήλ	iz.maˈel
Ἰσόνδαι	iˈson.dɛ
Ἰταλός	i.taˈlos
Ἰφιγένεια	i.pʰiˈɡɛ.ni.a
Ἰωνόπολις	i.oˈno.po.lis
Ἰόππη	iˈop.pi
Ἱεριχώ	(h)i.ɛ.riˈkʰo
Ἱεροφῶν	(h)i.ɛ.roˈpʰon
Ἴσβουρος	ˈiz.bu.ros
Ἴτυλος	ˈi.ty.los
ὀβελίσκος	o.bɛˈlis.kos
ὀκρίς	oˈkris
ὀλιγαρχικός	o.li.ɡar.kʰiˈkos
ὀλιγοψυχέω	o.li.ɡop.syˈkʰɛ.o
ὀλοφυδνός	o.lo.pʰyˈdnos
ὀνίσκος	oˈnis.kos
ὀνειδίζω	o.niˈdi.zo
ὀνομαστικόν	o.no.mas.tiˈkon
ὀξύα	okˈsy.a
ὀξύϊνος	okˈsy.i.nos
ὀπάλλιος	oˈpal.li.os
ὀπτός	opˈtos
ὀργίζω	orˈɡi.zo
ὀρθοδοξία	or.tʰo.dokˈsi.a
ὀροφή	o.roˈpʰe
ὀρυμαγδός	o.ry.maɡˈdos
ὀρχέομαι	orˈkʰɛ.o.mɛ
ὀστοῦν	osˈtun
ὀχθέω	okʰˈtʰɛ.o
ὀψοθήκη	op.soˈtʰe.ke
ὁμοιότροπος	(h)o.myˈo.tro.pos
ὁρίζων	(h)oˈri.zon
ὁρμαθός	(h)or.maˈtʰos
ὄβρυζον	ˈo.bry.zon
ὄγμος	ˈoɡ.mos
ὄλλυμι	ˈol.ly.mi
ὄμφαξ	ˈom.pʰaks
ὄνυμα	ˈo.ny.ma
ὄπισθεν	ˈo.pis.tʰɛn
ὄρεξις	ˈo.rɛk.sis
ὄφελον	ˈo.pʰɛ.lon
ὅθεν	ˈ(h)o.tʰɛn
ὅμιλος	ˈ(h)o.mi.los
ὅμορος	ˈ(h)o.mo.ros
ὅπλον	ˈ(h)o.plon
ὅρασις	ˈ(h)o.ra.sis
ὅσιος	ˈ(h)o.si.os
ὅσπερ	ˈ(h)os.pɛr
ὅσσος	ˈ(h)os.sos
ὅτε	ˈ(h)o.tɛ
ὅττι	ˈ(h)ot.ti
Ὀδυσεύς	o.dyˈseʍs
Ὀδόμαντοι	oˈdo.man.ty
Ὀλοοσσών	o.lo.osˈson
Ὀλύμπιος	oˈlym.pi.os
Ὀμβρική	om.briˈke
Ὀξύρρυγχος	okˈsyr̥.r̥yŋ.kʰos
Ὀποῦς	oˈpus
Ὀρνεάτης	or.nɛˈa.tes
Ὀροίτης	oˈry.tes
Ὀφρύνειον	oˈpʰry.ni.on
Ὁρτήσιος	(h)orˈte.si.os
Ὄλβασα	ˈol.ba.sa
ὑγρόφθογγος	(h)yˈɡropʰ.tʰoŋ.ɡos
ὑδροκέφαλον	(h)y.droˈkɛ.pʰa.lon
ὑδροσκόπιον	(h)y.drosˈko.pi.on
ὑπέρφρων	(h)yˈpɛr.pʰron
ὑπαλλάσσω	(h)y.palˈlas.so
ὑπερνέφελος	(h)y.pɛrˈnɛ.pʰɛ.los
ὑπηρεσία	(h)y.pe.rɛˈsi.a
ὑποκλέπτω	(h)y.poˈklɛp.to
ὑπομένω	(h)y.poˈmɛ.no
ὑποστάτης	(h)y.posˈta.tes
ὑποτελέω	(h)y.po.tɛˈlɛ.o
ὑπόβαθρον	(h)yˈpo.ba.tʰron
ὑπόδημα	(h)yˈpo.de.ma
ὑστέρημα	(h)ysˈtɛ.re.ma
ὑφήγησις	(h)yˈpʰe.ɡe.sis
ὑψόθεν	(h)ypˈso.tʰɛn
ὑόφθαλμος	(h)yˈopʰ.tʰal.mos
ὔμμες	ˈym.mɛs
ὕαλος	ˈ(h)y.a.los
ὕπατος	ˈ(h)y.pa.tos
ὕραξ	ˈ(h)y.raks
ὕψι	ˈ(h)yp.si
ὗς	(h)ys
Ὑμαίς	(h)yˈmɛs
Ὑπερβερεταῖος	(h)y.pɛr.bɛ.rɛˈtɛ.os
Ὑπερησίη	(h)y.pɛ.reˈsi.e
Ὕβλη	ˈ(h)y.ble
Ὕδισσα	ˈ(h)y.dis.sa
Ὕσσος	ˈ(h)ys.sos
ὠκιμοειδές	o.ki.mo.iˈdɛs
ὠμοτριβής	o.mo.triˈbes
ὠφελέω	o.pʰɛˈlɛ.o
ὤ	o
ὤρα	ˈo.ra
Ὠρίων	oˈri.on
Ὠστία	osˈti.a
ᾠδή	oˈde
ῥάσμα	ˈr̥az.ma
ῥαμμάτινος	r̥amˈma.ti.nos
ῥαφιδοθήκη	r̥a.pʰi.doˈtʰe.ke
ῥεῖθρον	ˈr̥i.tʰron
ῥητορικός	r̥e.to.riˈkos
ῥινοτόρος	r̥i.noˈto.ros
ῥισκοφύλαξ	r̥is.koˈpʰy.laks
ῥομβοειδής	r̥om.bo.iˈdes
ῥυθμός	r̥ytʰˈmos
ῥυπαροφάγος	r̥y.pa.roˈpʰa.ɡos
ῥυτίς	r̥yˈtis
ῥωχμός	r̥okʰˈmos
ῥώμη	ˈr̥o.me
ῥᾴθυμος	ˈr̥a.tʰy.mos
Ῥάβεννα	ˈr̥a.bɛn.na
Ῥέα	ˈr̥ɛ.a
Ῥήβας	ˈr̥e.bas
Ῥήνεια	ˈr̥e.ni.a
Ῥιζοῦς	r̥iˈzus
Ῥουβήν	r̥uˈben
Ῥόδη	ˈr̥o.de
