abante	aˈβan.te
abanteo	aˈβan.te.oː
abbato	ˈaβ.βa.toː
abbatuo	aβˈβa.tu.oː
abbibero	aβˈβi.βe.roː
absedii	apˈsɛ.di.iː
absedium	apˈsɛ.di.um
abyssimus	aˈβes.si.mus
acca	ˈak.ka
accapo	ˈak.ka.poː
accaptio	akˈkap.ti.oː
accapto	akˈkap.toː
accognito	akˈkɔɡ.ni.toː
accolligo	akˈkɔl.li.ɡoː
accollo	akˈkɔl.loː
accomplesco	ak.komˈpleːs.koː
accomplire	ak.komˈpliː.re
accordare	ak.korˈdaː.re
accordo	akˈkɔr.doː
accum	ˈak.kum
accum hic	ˈak.kum iːk
accum ille	ˈak.kum ˈil.le
accum ipse	ˈak.kum ˈip.se
accum iste	ˈak.kum ˈis.te
acquaerio	akˈkʷe.ri.oː
acquaerire	ak.kʷeˈriː.re
acrus	ˈaː.krus
actualis	aːk.tuˈaː.lis
acucla	aˈkuː.kla
acuclae	aˈkuː.kle
acutiare	a.kuː.tiˈaː.re
acutio	aˈkuː.ti.oː
ad bassum	ad ˈβas.sum
ad hic	ad iːk
ad retro	arˈrɛ.troː
ad satis	asˈsa.tis
adaquo	ˈa.da.kʷoː
adbassiare	ad.βas.siˈaː.re
adbassio	aβˈβas.si.oː
adbellesco	ad.βelˈleːs.koː
adbracchio	adβˈrak.kʰi.oː
adiuxtare	ad.jusˈtaː.re
adiuxto	adˈjus.toː
adminaciare	ad.mi.naː.kiˈaː.re
adminacio	ad.miˈnaː.ki.oː
admortesco	ad.morˈteːs.koː
admortire	ad.morˈtiː.re
adnecai	ad.neˈkaː.iː
adnecare	ad.neˈkaː.re
adnecatu	ad.neˈkaː.tu
adneco	ˈad.ne.koː
adoclare	a.doˈklaː.re
adoclo	ˈa.do.kloː
adpacare	at.paːˈkaː.re
adpressum	apˈprɛs.sum
adventura	ad.βenˈtuː.ra
adverare	ad.βeːˈraː.re
advero	adˈβeː.roː
advitiare	ad.βi.tiˈaː.re
advitio	adˈβi.ti.oː
aer	ˈaː.eːr
aera	ˈe.ra
aerosus	eˈroː.sus
aetatici	eˈtaː.ti.kiː
aetaticum	eˈtaː.ti.kum
aether	ˈe.tʰeːr
affidavit	af.fiːˈdaː.βit
affumare	af.fuːˈmaː.re
affumo	afˈfuː.moː
affundare	af.funˈdaː.re
affundo	afˈfun.doː
agesco	aˈɡeːs.koː
aiunus	ajˈjuː.nus
alemosyna	a.leːˈmɔ.se.na
alemosyne	a.leˈmɔ.se.neː
alicunus	a.liˈkuː.nus
alima	ˈa.li.ma
aliquis	ˈa.li.kʷis
alisna	aˈlis.na
allactare	al.lakˈtaː.re
allacto	alˈlak.toː
allo	ˈal.loː
alluminare	al.luː.miˈnaː.re
allumino	alˈluː.mi.noː
altiare	al.tiˈaː.re
altio	ˈal.ti.oː
amaricus	aˈmaː.ri.kus
ambito	ˈam.βi.toː
ambosta	amˈβɔs.ta
amicitas	aˈmiː.ki.taːs
amicitatis	a.mi.kiˈtaː.tis
Anconitanus	an.koː.niˈtaː.nus
ando	ˈan.doː
anteanus	an.teˈaː.nus
apeliotes	a.peː.liˈoː.teːs
apicla	aˈpi.kla
apozema	aˈpɔz.ze.ma
appacare	ap.paːˈkaː.re
appaco	apˈpaː.koː
appariculare	ap.pa.ri.kuˈlaː.re
appariculo	ap.paˈri.ku.loː
appodiare	ap.po.diˈaː.re
appodio	apˈpɔ.di.oː
arbalista	ar.βaˈlis.ta
arbaliste	ar.βaˈlis.teː
arborus	ˈar.βo.rus
arcio	ˈar.ki.oː
arcionis	ar.kiˈoː.nis
ardere	ˈaːr.de.re
ardo	ˈaːr.doː
arrestare	ar.resˈtaː.re
arresto	arˈrɛs.toː
arripare	ar.riːˈpaː.re
arripo	arˈriː.poː
asciola	asˈki.o.la
ascla	ˈas.kla
ascle	ˈas.kleː
aspergo	asˈpɛr.ɡoː
assalto	asˈsal.toː
assecurare	as.se.kuːˈraː.re
assecuro	as.seˈkuː.roː
assequor	ˈas.se.kʷor
-aster	ˈas.ter
attitiare	at.tiː.tiˈaː.re
attitio	atˈtiː.ti.oː
attragere	atˈtra.ɡe.re
attrago	ˈat.tra.ɡoː
auca	ˈau̯.ka
auctorizo	au̯k.toːˈriz.zoː
auratus	au̯ˈraː.tus
ausare	au̯ˈsaː.re
auso	ˈau̯.soː
autumnus	au̯ˈtum.nus
avicella	a.βiˈkɛl.la
aviola	aˈβi.o.la
aviolus	aˈβi.o.lus
axio	ˈa.si.oː
baba	ˈβa.βa
babbus	ˈβaβ.βus
Babylonia	βa.βeˈloː.ni.a
baccinum	ˈβak.ki.num
baiulivi	βajˈju.li.βi
baiulivus	βaj.juˈliː.βus
balbo	ˈβal.βoː
bannio	ˈβan.ni.oː
bannire	βanˈniː.re
barra	ˈβar.ra
barrae	ˈβar.re
barrum	ˈβar.rum
bassiare	βas.siˈaː.re
bassio	ˈβas.si.oː
bastare	βasˈtaː.re
basto	ˈβas.toː
bataclum	βaˈta.klum
bellitas	ˈβɛl.li.taːs
bellitatis	βel.liˈtaː.tis
bellitia	βelˈli.ti.a
bene venitus	ˈβɛ.ne βeˈniː.tus
bene venutus	ˈβɛ.ne βeˈnuː.tus
bibo	ˈβi.βoː
bisomum	βiˈsoː.mum
bisonium	βiˈsɔ.ni.um
blancus	ˈβlan.kus
blastemo	ˈβlas.te.moː
blastimo	ˈβlas.ti.moː
blavus	ˈβlaː.βus
boscaticum	βosˈkaː.ti.kum
bragio	ˈβra.ɡi.oː
brandus	ˈβran.dus
brigna	ˈβriɡ.na
bullicare	βul.liˈkaː.re
bullico	ˈβul.li.koː
butyrum	βuːˈteː.rum
Byzantion	βeːzˈzan.ti.on
Byzantium	βeːzˈzan.ti.um
cadentia	kaˈdɛn.ti.a
cadentie	kaˈdɛn.ti.eː
cadeo	ˈka.de.oː
cadere	kaˈdeː.re
Caesaraugusta	ke.sa.rau̯ˈɡus.ta
Callirhoe	kalˈli.ro.eː
Callirrhoe	kalˈlir.ro.eː
cambiare	kam.βiˈaː.re
cambiavi	kam.βiˈaː.βiː
cambio	ˈkam.βi.oː
cambire	kamˈβiː.re
cambium	ˈkam.βi.um
camminus	kamˈmiː.nus
cancriclus	kanˈkri.klus
capitina	ka.piˈtiː.na
cappella	kapˈpɛl.la
cappellus	kapˈpɛl.lus
capum	ˈka.pum
carnaceus	karˈnaː.ke.us
casco	ˈkas.koː
casicare	ka.siˈkaː.re
casico	ˈkaː.si.koː
catunum	kaˈtuː.num
caulae	ˈkau̯.le
cauterium	kau̯ˈteː.ri.um
caveola	kaˈβɛ.o.la
cavula	ˈka.βu.la
cawa	ˈka.βa
cedo	ˈkeː.doː
chirurgianus	kʰiː.rur.ɡiˈaː.nus
chronicus	ˈkʰrɔ.ni.kus
cicala	kiːˈkaː.la
cinquaginta	kiːn.kʷaːˈɡin.taː
cinque	ˈkiːn.kʷe
cinusia	kiˈnuː.si.a
circus	ˈkir.kus
cito	ˈki.toː
civis romanus sum	ˈkiː.βis roːˈmaː.nus sum
clapare	klaˈpaː.re
clapo	ˈkla.poː
clubium	ˈklu.βi.um
cnifus	ˈkniː.fus
coacticare	ko.ak.tiˈkaː.re
coalitio	ko.aˈli.ti.oː
cocinarius	ko.kiːˈnaː.ri.us
colligo	ˈkɔl.li.ɡoː
coloco	ˈkɔ.lo.koː
columbinus	ko.lumˈβiː.nus
combattere	komˈβat.te.re
combatto	komˈβat.toː
cominitio	ko.miˈni.ti.oː
commandare	kom.manˈdaː.re
commando	komˈman.doː
complesco	komˈpleːs.koː
complire	komˈpliː.re
confesso	konˈfɛs.soː
Constantinopolis	kon.stan.tiːˈnɔ.po.lis
contingesco	kon.tinˈɡeːs.koː
contio	ˈkoːn.ti.oː
contrafacio	kon.traːˈfa.ki.oː
convitare	kon.βiːˈtaː.re
convito	konˈβiː.toː
coratio	koˈraː.ti.oː
corationis	ko.raː.tiˈoː.nis
cordarius	korˈdaː.ri.us
cosere	ˈkoː.se.re
cosio	ˈkoː.si.oː
cosire	koːˈsiː.re
coso	ˈkoː.soː
crapulor	ˈkraː.pu.lor
crapulosus	kraː.puˈloː.sus
crebellum	kreˈβɛl.lum
cremere	ˈkrɛ.me.re
cremo	ˈkrɛ.moː
cruralis	kruːˈraː.lis
cultus	ˈkul.tus
cum	kum
cunicli	ˈku.ni.kliː
cuniclus	kuˈni.klus
cyclops	ˈke.kloːps
damnaticum	damˈnaː.ti.kum
dancio	ˈdan.ki.oː
decembrius	deˈkɛmβ.ri.us
deexcitare	deː.es.kiˈtaː.re
deexcito	deːˈɛs.ki.toː
deiformis	de.iˈfɔr.mis
deintus	deˈin.tus
delebilis	deːˈleː.βi.lis
deletio	deːˈleː.ti.oː
delicatiare	de.li.ka.tiˈaː.re
delicatio	de.liˈka.ti.oː
deorsum	deˈɔr.sum
depanare	deː.paːˈnaː.re
depano	deːˈpaː.noː
derectiare	deː.reːk.tiˈaː.re
derectio	deːˈreːk.ti.oː
derectus	deːˈreːk.tus
deripare	de.riːˈpaː.re
deripo	deˈriː.poː
desiderosus	deː.siː.deˈroː.sus
desidium	deːˈsi.di.um
destrugere	deːsˈtru.ɡe.re
destrugo	ˈdeːs.tru.ɡoː
Deus	ˈdɛ.us
deviatio	deː.βiˈaː.ti.oː
dia	ˈdiː.a
Diana	diˈaː.na
diatim	diˈaː.tim
dietim	diˈeː.tim
dire	ˈdiː.re
discalceus	disˈkal.ke.us
disculceus	disˈkal.ke.us
dismerdare	dis.merˈdaː.re
diurnus	diˈur.nus
dius	ˈdiː.us
Divana	diːˈβaː.na
domna	ˈdɔm.na
domnicella	dom.niˈkɛl.la
drectus	ˈdreːk.tus
dullia	ˈdul.li.a
ebrietas	eːβˈri.e.taːs
eccere	ˈɛk.ke.re
eccille	ekˈkil.le
eccu hic	ˈɛk.ku iːk
eo	ˈɛ.o
ephesius	eˈfɛ.si.us
epopta	eˈpɔp.ta
epoptes	eˈpɔp.teːs
eremiticus	e.reːˈmiː.ti.kus
ergere	ˈeːr.ɡe.re
ergo	ˈeːr.ɡoː
escarius	eːsˈkaː.ri.us
exalbo	eˈsal.βoː
excadeo	esˈka.de.oː
excadere	es.kaˈdeː.re
excadescere	es.kaˈdɛs.ke.re
excadesco	es.kaˈdɛs.koː
excalceus	esˈkal.ke.us
excambio	esˈkam.βi.oː
excappo	esˈkap.poː
excarmino	esˈkar.mi.noː
excorrigiata	es.kor.riˈɡi.a.ta
exeligere	e.seːˈli.ɡe.re
exeligo	eˈseː.li.ɡoː
exfortio	esˈfɔr.ti.oː
exfrido	ˈɛs.fri.doː
expaventare	es.pa.βenˈtaː.re
expavento	es.paˈβɛn.toː
experlavo	esˈpɛr.la.βoː
extorcere	esˈtɔr.ke.re
extorco	esˈtɔr.koː
extutare	es.tuːˈtaː.re
extuto	esˈtuː.toː
exvento	esˈβɛn.toː
exvolare	es.βoˈlaː.re
exvolo	ˈɛs.βo.loː
fabellare	faː.βelˈlaː.re
fabello	faːˈβɛl.loː
facia	ˈfa.ki.a
fallescere	falˈleːs.ke.re
fallesco	falˈleːs.koː
Fata	ˈfaː.ta
feminus	ˈfeː.mi.nus
fendo	ˈfɛn.doː
festizo	feːsˈtiz.zoː
festuca	fesˈtuː.ka
fetiolus	feːˈti.o.lus
fibella	fiːˈβɛl.la
ficco	ˈfiːk.koː
figico	ˈfiː.ɡi.koː
finesco	fiːˈneːs.koː
finire	fiːˈniː.re
fio	ˈfi.oː
flasca	ˈflas.ka
fleccia	ˈflɛk.ki.a
florire	floːˈriː.re
flotus	ˈfloː.tus
focacia	foˈkaː.ki.a
fortia	ˈfɔr.ti.a
fortiare	for.tiˈaː.re
fortio	ˈfɔr.ti.oː
frappo	ˈfrap.poː
frictura	friːkˈtuː.ra
friscus	ˈfris.kus
frocus	ˈfroː.kus
garra	ˈɡar.ra
gazophylacium	ɡaz.zo.feˈla.ki.um
genethliacus	ɡe.netʰˈli.a.kus
genuclum	ɡeˈnu.klum
glacia	ˈɡla.ki.a
glacialis	ɡla.kiˈaː.lis
glandarius	ɡlanˈdaː.ri.us
grabo	ˈɡra.βoː
Graecia	ˈɡre.ki.a
Graecus	ˈɡre.kus
guerra	ɡuˈɛr.ra
habutus	aˈβuː.tus
halenare	a.leˈnaː.re
haleno	ˈa.le.noː
haliurunna	a.li.uˈrun.na
halsbergus	alsˈβɛr.ɡus
harpa	ˈar.pa
haunio	ˈau̯.ni.oː
Helene	ˈɛ.le.neː
hemicrania	eː.miˈkraː.ni.a
hendo	ˈɛn.doː
heu	eu̯
Hispaniolus	is.paːˈni.o.lus
honta	ˈoːn.ta
horarium	oːˈraː.ri.um
horripilo	orˈri.pi.loː
hortatorius	or.taːˈtoː.ri.us
hydromantia	e.dro.manˈtiː.a
hydromantis	e.droˈman.tis
hypaethrus	ˈe.pe.tʰrus
i graeca	iː ˈɡre.ka
Iana	ˈjaː.na
ianuella	jaː.nuˈɛl.la
-idiare	i.diˈaː.re
-idio	ˈi.di.o
ieniperus	jeːˈni.pe.rus
illu	ˈil.lu
imbibito	imˈβi.βi.toː
imboscare	im.βosˈkaː.re
imbosco	imˈβɔs.koː
impenetrabilis	im.pe.neˈtraː.βi.lis
implio	ˈim.pli.oː
implire	imˈpliː.re
impositum	imˈpoː.si.tum
imprehendere	im.preˈɛn.de.re
imprehendo	im.preˈɛn.doː
inalbo	iˈnal.βoː
inaltio	iˈnal.ti.oː
inaltus	iˈnal.tus
incaldesco	in.kalˈdeːs.koː
incaldire	in.kalˈdiː.re
incarrico	inˈkar.ri.koː
inclago	ˈin.kla.ɡoː
incohativus	in.ko.aːˈtiː.βus
incoho	ˈin.ko.oː
indenso	inˈdɛn.soː
indigitamenta	in.di.ɡi.taːˈmɛn.ta
indigito	inˈdi.ɡi.toː
indolens	ˈin.do.lens
indulcesco	in.dulˈkeːs.koː
indulcire	in.dulˈkiː.re
infacundus	in.faːˈkun.dus
inferus	ˈin.fe.rus
ingrevico	inˈɡrɛ.βi.koː
innubus	ˈin.nu.βus
inodorus	i.noˈdoː.rus
interminabilis	in.ter.miˈnaː.βi.lis
interro	inˈtɛr.roː
intorco	inˈtɔr.koː
inuxoro	iˈnu.so.roː
invirdesco	in.βirˈdeːs.koː
invitio	inˈβi.ti.oː
iocare	joˈkaː.re
ioco	ˈjɔ.koː
ipsimus	ˈip.si.mus
Iraquia	iˈraː.kʷi.a
-issimus	ˈis.si.mus
iudaizo	juː.daˈiz.zoː
iugaster	juˈɡas.ter
iusum	ˈjuː.sum
-izo	ˈiz.zo
Jana	ˈjaː.na
Janae	ˈjaː.ne
lacartus	laˈkar.tus
laitus	ˈla.i.tus
languio	ˈlan.ɡʷi.oː
languire	lanˈɡʷiː.re
lapidesco	la.piˈdeːs.koː
latens	ˈla.tens
latentior	laˈtɛn.ti.or
latentissime	la.tenˈtis.si.me
latentissimus	la.tenˈtis.si.mus
latentius	laˈtɛn.ti.us
lateo	ˈla.te.oː
Latina	laˈtiː.na
latinae	laˈtiː.ne
latini	laˈtiː.niː
latinum	laˈtiː.num
Latinus	laˈtiː.nus
laubia	ˈlau̯.βi.a
lausa	ˈlau̯.sa
leviarius	le.βiˈaː.ri.us
limitrophus	liːˈmi.tro.fus
linguaticum	linˈɡʷaː.ti.kum
longitanus	lon.ɡiˈtaː.nus
longiturnus	lon.ɡiˈtur.nus
lucio	ˈluː.ki.oː
lucire	luːˈkiː.re
machinare	maː.kʰiˈnaː.re
machino	ˈmaː.kʰi.noː
mador	ˈma.dor
mais	majs
malifatius	ma.liˈfaː.ti.us
mana	ˈma.na
maneana	maːˈnɛ.a.na
mania	ˈma.ni.a
manizare	ma.nizˈzaː.re
manizo	maˈniz.zoː
masticatio	mas.tiˈkaː.ti.oː
matrastra	maːˈtras.tra
matrina	maːˈtriː.na
matrinae	maːˈtriː.ne
melis	ˈmɛ.lis
melum	ˈmeː.lum
melus	ˈmeː.lus
mentio	ˈmɛn.ti.oː
metio	ˈmeː.ti.oː
metipse	meˈtip.se
metipsimus	meˈtip.si.mus
metire	meːˈtiː.re
minacia	miˈnaː.ki.a
minaciare	mi.naː.kiˈaː.re
minacio	miˈnaː.ki.oː
minare	miˈnaː.re
minctio	ˈmiːnk.ti.oː
mino	ˈmi.noː
misculare	mis.kuˈlaː.re
misculo	ˈmis.ku.loː
montania	monˈtaː.ni.a
montare	monˈtaː.re
mordere	ˈmɔr.de.re
mordo	ˈmɔr.doː
morio	ˈmɔ.ri.oː
morire	moˈriː.re
moveo	ˈmɔ.βe.oː
movere	ˈmɔ.βe.re
movo	ˈmɔ.βoː
muccare	mukˈkaː.re
mucco	ˈmuk.koː
mulgere	ˈmul.ɡe.re
mulgo	ˈmul.ɡoː
mulier	ˈmu.li.er
muneratio	muː.neˈraː.ti.oː
murrum	ˈmur.rum
musclus	ˈmuːs.klus
muso	ˈmu.soː
neapolitanus	ne.aː.po.liːˈtaː.nus
ni	niː
niloticus	niːˈloː.ti.kus
nivare	niˈβaː.re
nivicare	ni.βiˈkaː.re
nivico	ˈni.βi.koː
nivo	ˈni.βoː
noco	ˈnɔ.koː
noto	ˈnɔ.toː
novaginta	noː.βaːˈɡin.taː
novus	ˈnɔ.βus
nuo	ˈnu.oː
oblitare	oβ.liːˈtaː.re
oblito	oβˈliː.toː
octennis	okˈtɛn.nis
odiare	o.diˈaː.re
odio	ˈɔ.di.oː
odoratus	o.doːˈraː.tus
odorifer	oˈdoː.ri.fer
odorus	oˈdoː.rus
offerescere	of.feˈreːs.ke.re
offeresco	of.feˈreːs.koː
offerio	ofˈfɛ.ri.oː
offerire	of.feˈriː.re
oleo	ˈɔ.le.oː
optimus	ˈɔp.ti.mus
ordio	ˈoːr.di.oː
ordire	oːrˈdiː.re
orgollio	orˈɡoːl.li.oː
oricla	oːˈrik.kla
orulare	oː.ruˈlaː.re
orulo	ˈoː.ru.loː
oryza	oˈreːz.za
otior	ˈoː.ti.or
paeninsula	peˈnin.su.la
pannosus	panˈnoː.sus
Panormitanus	pa.nor.miˈtaː.nus
papyrio	paˈpeː.ri.oː
papyrius	paˈpeː.ri.us
paresco	paːˈrɛs.koː
Pasiphaa	paːˈsi.fa.a
Pasiphae	paːˈsi.fa.eː
passare	pasˈsaː.re
passarus	ˈpas.sa.rus
passo	ˈpas.soː
pater	ˈpa.ter
patrini	paˈtriː.niː
patrinus	paˈtriː.nus
patta	ˈpat.ta
pedisequus	peˈdi.se.kʷus
peltrum	ˈpɛl.trum
pendicare	pen.diˈkaː.re
pendico	ˈpɛn.di.koː
penis	ˈpeː.nis
perdonare	per.doːˈnaː.re
perdono	perˈdoː.noː
peresco	peˈreːs.koː
periturus	pe.riˈtuː.rus
Persa	ˈpɛr.sa
Perses	ˈpɛr.seːs
petio	ˈpɛ.ti.oː
petire	peˈtiː.re
pharmaceuticus	far.maˈkeu̯.ti.kus
philtrum	ˈfil.trum
phrenesis	freˈneː.sis
picco	ˈpiːk.koː
piccus	ˈpiːk.kus
picto	ˈpik.toː
pincio	ˈpiːn.ki.oː
piscare	pisˈkaː.re
pisco	ˈpis.koː
pissiare	piːs.siˈaː.re
pissio	ˈpiːs.si.oː
plattus	ˈplat.tus
ploppus	ˈploːp.pus
plovere	ˈplɔ.βe.re
plovo	ˈplɔ.βoː
podio	ˈpɔ.di.oː
posso	ˈpɔs.soː
postius	ˈpɔs.ti.us
praetexo	ˈpre.te.soː
praetextum	preˈtɛs.tum
precare	preˈkaː.re
preco	ˈprɛ.koː
primavera	priː.maˈβeː.ra
profecticius	pro.fekˈtiː.ki.us
profectitius	pro.fekˈtiː.ti.us
proscaenium	prosˈke.ni.um
proscenium	prosˈkeː.ni.um
pulica	ˈpuː.li.ka
pullarius	pulˈlaː.ri.us
pullastra	pulˈlas.tra
pullus	ˈpul.lus
punctio	ˈpuːnk.ti.oː
puppa	ˈpup.pa
putiare	pu.tiˈaː.re
putio	ˈpuː.ti.oː
putire	puˈtiː.re
putrio	ˈpu.tri.oː
putrire	puˈtriː.re
quando	ˈkʷan.doː
quaresima	kʷa.reːˈsiː.ma
quassicare	kʷas.siˈkaː.re
quassico	ˈkʷas.si.koː
quinquennis	kʷiːnˈkʷɛn.nis
quomo	ˈkʷoː.mo
rabia	ˈra.βi.a
ranceo	ˈran.ke.oː
raspo	ˈras.poː
Reatini	re.aːˈtiː.niː
Reatinus	re.aːˈtiː.nus
reexcaptare	re.es.kapˈtaː.re
reexcapto	re.esˈkap.toː
refusare	re.fuːˈsaː.re
refuso	reˈfuː.soː
rencus	ˈrɛn.kus
rendere	ˈrɛn.de.re
rendo	ˈrɛn.doː
renio	ˈreː.ni.oː
repoenitio	re.peˈni.ti.oː
retina	ˈrɛ.ti.na
ridio	ˈriː.di.oː
rido	ˈriː.doː
rosicare	roː.siˈkaː.re
rosico	ˈroː.si.koː
rossa	ˈrɔs.sa
saeculum	ˈse.ku.lum
sagia	ˈsa.ɡi.a
sambatum	ˈsam.βa.tum
sanguinitas	sanˈɡʷi.ni.taːs
sanitosus	saː.niˈtoː.sus
sapeo	ˈsa.pe.oː
sapere	saˈpeː.re
saporo	saˈpoː.roː
sarclare	sarˈklaː.re
sarclo	ˈsar.kloː
scaena	ˈske.na
scermio	ˈskɛr.mi.oː
scopula	ˈskoː.pu.la
scribio	ˈskriː.βi.oː
scrofulae	ˈskroː.fu.le
secus	ˈsɛ.kus
sedentare	se.denˈtaː.re
sedento	seˈdɛn.toː
semitarius	seː.miˈtaː.ri.us
sennus	ˈsɛn.nus
septembrius	sepˈtɛmβ.ri.us
septennis	sepˈtɛn.nis
septuennis	sep.tuˈɛn.nis
sequio	ˈsɛ.kʷi.oː
sequire	seˈkʷiː.re
sescuncia	seːsˈkuːn.ki.a
sicilo	siːˈkiː.loː
smeralda	smeˈral.da
smeraldus	smeˈral.dus
socra	ˈsɔ.kra
solicli	ˈsɔ.li.kliː
soliclus	ˈsɔ.li.klus
somnolentus	som.noˈlɛn.tus
Sophoclae	ˈsɔ.fo.kle
Sophocle	ˈsɔ.fo.kleː
Sophoclea	so.foˈkleː.a
Sophoclem	ˈsɔ.fo.klem
Sophocles	ˈsɔ.fo.kleːs
Sophocli	ˈsɔ.fo.kliː
Sophoclis	ˈsɔ.fo.klis
sorbio	ˈsɔr.βi.oː
sorbire	sorˈβiː.re
sortiarius	sor.tiˈaː.ri.us
spiare	spiˈaː.re
spio	ˈspi.oː
stagno	ˈstaːɡ.noː
strinctus	ˈstrink.tus
stuno	ˈstu.noː
subridere	suβˈriː.de.re
subrido	suβˈriː.doː
sufferio	sufˈfɛ.ri.oː
sufferire	suf.feˈriː.re
superanus	su.peˈraː.nus
surrupo	surˈruː.poː
Syracusae	se.raːˈkuː.se
tam magnus	tam ˈmaɡ.nus
taranca	taˈran.ka
tardivus	tarˈdiː.βus
tastare	tasˈtaː.re
tasto	ˈtas.toː
Teatinus	te.aːˈtiː.nus
tenio	ˈtɛ.ni.oː
tenire	teˈniː.re
timo	ˈtiː.moː
tiro	ˈtiː.roː
tocco	ˈtɔk.koː
toppus	ˈtɔp.pus
torcere	ˈtɔr.ke.re
torco	ˈtɔr.koː
tractio	ˈtrak.ti.oː
traginare	tra.ɡiˈnaː.re
tragino	ˈtra.ɡi.noː
tragoedus	ˈtra.ɡe.dus
tragula	ˈtraː.ɡu.la
tremare	treˈmaː.re
trespes	ˈtreːs.peːs
trico	ˈtriː.koː
trifolum	ˈtri.fo.lum
tripaliare	tri.pa.liˈaː.re
tripalio	triˈpa.li.oː
tripes	ˈtri.peːs
tropare	troˈpaː.re
tropo	ˈtrɔ.poː
trudico	ˈtruː.di.koː
turdela	turˈdeː.la
Tuscia	ˈtus.ki.a
tutare	tuːˈtaː.re
tutellus	tuːˈtɛl.lus
tuto	ˈtuː.toː
Tyrrhenia	terˈreː.ni.aː
undivagus	unˈdi.βa.ɡus
undizare	un.dizˈzaː.re
undizo	unˈdiz.zoː
usare	uːˈsaː.re
uso	ˈuː.soː
vacantia	βaˈkan.ti.a
vacca	ˈβak.ka
veclus	ˈβɛ.klus
Vedius	βeːˈdiː.us
Vejovis	ˈβeː.jo.βis
vera	ˈβeː.ra
veranum	βeːˈraː.num
versura	βerˈsuː.ra
vestitura	βes.tiːˈtuː.ra
vexica	βeːˈsiː.ka
via	ˈβi.a
video	ˈβi.de.oː
virdia	ˈβir.di.a
visaticum	βiːˈsaː.ti.kum
vispellio	βisˈpɛl.li.oː
voltare	βolˈtaː.re
volto	ˈβɔl.toː
vox populi	βoːs ˈpɔ.pu.liː
vulnero	ˈβul.ne.roː
wadanio	βaˈda.ni.oː
wardo	ˈβar.doː
warnio	ˈβar.ni.oː
werra	ˈβɛr.ra
werrizo	βerˈriz.zoː
ypsilon	eːpˈsiː.lon
zephyrus	ˈzɛ.fe.rus
zeta	ˈzeː.ta
zeugma	ˈzeu̯ɡ.ma
