-ійський	 ˈii̯sʲkei̯
Іван	iˈʋan
Амстердам	ɐmsterˈdam
Андрій	ɐnˈdʲrʲii̯
Багамські Острови	bɐˈɦamsʲkʲi ɔstrɔˈʋɪ
Буття	bʊˈtʲːa
Біг Мак	bʲiɦ ˈmak
Венесуела	ʋenesʊˈɛɫɐ
Волинь	wɔˈɫɪnʲ
Вікісловник	ʋʲikʲisɫɔu̯ˈnɪk
Галич	ˈɦaɫet͡ʃ
Генасамблея	ɦenɐsɐmˈbɫɛjɐ
Георгій	ɦeˈɔrɦʲii̯
Гурченко	ˈɦurt͡ʃenkɔ
ДТП	dɛ tɛ ˈpɛ
Давид	dɐˈʋɪd
Дніпро	dʲnʲiˈprɔ
Домініка	dɔmʲiˈnʲikɐ
Житомир	ʒeˈtɔmer
Київ	ˈkɪjiu̯
Краків	ˈkrakʲiu̯
Кримський півострів	ˈkrɪmsʲkei̯ pʲiˈwɔstʲrʲiu̯
Куала-Лумпур	kʊˈaɫɐ ˈɫumpʊr
Ленін	ˈɫɛnʲin
Литвиненко	ɫetʋeˈnɛnkɔ
Лукашенко	ɫʊkɐˈʃɛnkɔ
Львів	lʲʋʲiu̯
Маастрихт	mɐaˈstrɪxt
Маланка	mɐˈɫankɐ
Могильов	mɔɦeˈlʲɔu̯
Молдова	mɔɫˈdɔʋɐ
Монако	mɔˈnakɔ
Москва	mɔskˈʋa
Навруз	nɐu̯ˈruz
Нігер	ˈnʲiɦer
Олеся	ɔˈɫɛsʲɐ
Пакистан	pɐkeˈstan
Папа	ˈpapɐ
Персефона	perseˈfɔnɐ
Петро	peˈtrɔ
Радянський Союз	rɐˈdʲanʲsʲkei̯ sɔˈjuz
Рейк&#039;явік	rei̯ˈkjaʋʲik
Російська Федерація	roˈsʲii̯sʲkɐ fedeˈrat͡sʲijɐ
Сент-Люсія	sɛnt ˈlʲusʲijɐ
Соломія	sɔɫoˈmʲijɐ
Стефанія	steˈfanʲijɐ
Уельс	ʊˈɛlʲs
Хмельницький	xmelʲˈnɪt͡sʲkei̯
Чехословаччина	t͡ʃexɔsɫɔˈʋat͡ʃːenɐ
Шрі-Ланка	ʃrʲi ɫɐnˈka
Юлія	ˈjulʲijɐ
абака	ɐˈbakɐ
абеткування	ɐbetkʊˈʋanʲːɐ
аблактування	ɐbɫɐktʊˈʋanʲːɐ
абонентка	ɐbɔˈnɛntkɐ
абразивність	ɐbrɐˈzɪu̯nʲisʲtʲ
абрикосник	ɐbreˈkɔsnek
абсолютизація	ɐbsɔlʲʊteˈzat͡sʲijɐ
абсорбер	ɐbˈsɔrber
абстрактність	ɐbˈstraktʲnʲisʲtʲ
абсурдність	ɐbˈsurdʲnʲisʲtʲ
абшит	ɐbˈʃɪt
абітурієнт	ɐbʲitʊrʲiˈjɛnt
аванзал	ɐʋɐnˈzaɫ
авансування	ɐʋɐnsʊˈʋanʲːɐ
авантюристка	ɐʋɐnʲtʲʊˈrɪstkɐ
аварка	ɐˈʋarkɐ
авлос	ɐu̯ˈɫɔs
австралопітек	ɐu̯strɐɫɔpʲiˈtɛk
австрійський	ɐu̯ˈstʲrʲii̯sʲkei̯
автоаерозапчастина	ɐu̯tɔɐerɔzɐpt͡ʃɐˈstɪnɐ
автобальзам	ɐu̯tɔbɐlʲˈzam
автобусик	ɐu̯ˈtɔbʊsek
автовиробник	ɐu̯tɔʋerɔbˈnɪk
автогенник	ɐu̯tɔˈɦɛnːek
автоматично	ɐu̯tɔmɐˈtɪt͡ʃnɔ
авторитарний	ɐu̯tɔreˈtarnei̯
авіавдар	ɐʋʲiɐu̯ˈdar
авіадиспетчер	ɐʋʲiɐdeˈspɛt͡ʃːer
авіаквиток	ɐʋʲiɐkʋeˈtɔk
авіамайстерня	ɐʋʲiɐmɐi̯ˈstɛrnʲɐ
авіамоторобудування	ɐʋʲiɐmɔtɔrɔbʊdʊˈʋanʲːɐ
авіапатрулювання	ɐʋʲiɐpɐtrʊlʲʊˈʋanʲːɐ
авіаракетобудування	ɐʋʲiɐrɐketɔbʊdʊˈʋanʲːɐ
авіатехнік	ɐʋʲiɐˈtɛxnʲik
авіафауна	ɐʋʲiɐˈfaʊnɐ
авізо	ɐˈʋʲizɔ
агенція	ɐˈɦɛnʲt͡sʲijɐ
ад&#039;ютант	ɐdjʊˈtant
аджика	ɐˈd͡ʒɪkɐ
аероскопія	ɐerɔskoˈpʲijɐ
академічний	ɐkɐdeˈmʲit͡ʃnei̯
активація	ɐkteˈʋat͡sʲijɐ
акціонер	ɐkt͡sʲiɔˈnɛr
албанка	ɐɫˈbankɐ
алло	ɐˈɫːɔ
амбітний	ɐmˈbʲitnei̯
анамнії	ɐˈnamnʲiji
англійська	ɐnˈɦlʲii̯sʲkɐ
ансамбль	ɐnˈsamblʲ
антиномічний	ɐntenoˈmʲit͡ʃnei̯
антонім	ɐnˈtɔnʲim
апелювати	ɐpelʲʊˈʋate
арахнологія	ɐrɐxnɔˈɫɔɦʲijɐ
арифметичний	ɐrefmeˈtɪt͡ʃnei̯
арсен	ɐrˈsɛn
архонт	ɐrˈxɔnt
архівний	ɐrˈxʲiu̯nei̯
аскетично	ɐskeˈtɪt͡ʃnɔ
атеїзм	ɐteˈjizm
аутсайдер	ɐʊˈt͡sai̯der
африканка	ɐfreˈkankɐ
б	b
бабка	ˈbabkɐ
багатолюдний	bɐɦɐtoˈlʲudnei̯
багнистий	bɐɦˈnɪstei̯
байдужий	bɐi̯ˈduʒei̯
балістичний	bɐlʲiˈstɪt͡ʃnei̯
банківський	ˈbanʲkʲiu̯sʲkei̯
барвистий	bɐrˈʋɪstei̯
батальйон	bɐtɐˈlʲjɔn
бачити	ˈbat͡ʃete
безвихідь	bezˈʋɪxʲidʲ
бездіяльний	bezʲdʲiˈjalʲnei̯
беззахисний	beˈzːaxesnei̯
безкраїй	bezˈkrajii̯
безнадійно	beznɐˈdʲii̯nɔ
безплідний	bezˈplʲidnei̯
безприкладний	bezˈprɪkɫɐdnei̯
безсторонність	bezstɔˈrɔnʲːisʲtʲ
безшлюбність	beʒʃˈlʲubnʲisʲtʲ
безіменний	bezʲiˈmɛnːei̯
бензиновий	benˈzɪnɔʋei̯
березневий	berezˈnɛʋei̯
бетонний	beˈtɔnːei̯
битися	ˈbɪtesʲɐ
благородний	bɫɐɦɔˈrɔdnei̯
близькість	ˈbɫɪzʲkʲisʲtʲ
блоха	bɫɔˈxa
богатир	bɔɦɐˈtɪr
богохульство	bɔɦoˈxulʲstwɔ
боліти	boˈlʲite
бомбардувати	bɔmbɐrdʊˈʋate
борода	bɔrɔˈda
бос	bɔs
боягузка	bɔjɐˈɦuzkɐ
брак	brak
братська могила	ˈbrat͡sʲkɐ mɔˈɦɪɫɐ
британський	breˈtanʲsʲkei̯
бронхіт	bronʲˈxʲit
бувати	bʊˈʋate
буддійський	bʊˈdʲːii̯sʲkei̯
будьмо	ˈbudʲmɔ
бульба	ˈbulʲbɐ
бурулька	bʊˈrulʲkɐ
бюрократія	bʲʊrɔˈkratʲijɐ
біженський	ˈbʲiʒenʲsʲkei̯
білок	bʲiˈɫɔk
біль	bʲilʲ
біографія	bʲiɔˈɦrafʲijɐ
біржа	ˈbʲirʒɐ
в&#039;язень	ˈʋjazenʲ
вада	ˈʋadɐ
вакцинація	ʋɐkt͡seˈnat͡sʲijɐ
ванна кімната	ˈʋanːɐ kʲimˈnatɐ
варити	ʋɐˈrɪte
ватрушка	ʋɐˈtruʃkɐ
введення	ˈʋːɛdenʲːɐ
вдосвіта	ˈwdɔsʲʋʲitɐ
ведучий	ʋeˈdut͡ʃei̯
великомученик	ʋeɫekoˈmut͡ʃenek
верем&#039;я	ʋeˈrɛmjɐ
вертикальний	ʋerteˈkalʲnei̯
вершина	ʋerˈʃɪnɐ
вестернізація	ʋesternʲiˈzat͡sʲijɐ
вже	wʒɛ
взагалі	wzɐɦɐˈlʲi
взаємовплив	wzɐjemɔu̯ˈpɫɪu̯
вибачити	ˈʋɪbɐt͡ʃete
вибрати	ˈʋɪbrɐte
вивчати	ʋeu̯ˈt͡ʃate
виграш	ˈʋɪɦrɐʃ
видача	ˈʋɪdɐt͡ʃɐ
вижити	ˈʋɪʒete
визнати	ˈʋɪznɐte
викладач	ʋekɫɐˈdat͡ʃ
виконати	ˈʋɪkɔnɐte
виліковувати	ʋelʲiˈkɔwʊʋɐte
вимирати	ʋemeˈrate
винайти	ˈʋɪnɐi̯te
винник	ˈʋɪnːek
винятковий	ʋenʲɐtˈkɔʋei̯
виправити	ˈʋɪprɐʋete
виробити	ˈʋɪrɔbete
вирушити	ˈʋɪrʊʃete
вирішення	ˈʋɪrʲiʃenʲːɐ
висловлюватися	ʋesˈɫɔu̯lʲʊʋɐtesʲɐ
високопосадовець	ʋesɔkɔpɔsɐˈdɔʋet͡sʲ
вистачити	ˈʋɪstɐt͡ʃete
витлумачити	ˈʋɪtɫʊmɐt͡ʃete
вихід	ˈʋɪxʲid
вичерпувати	ʋeˈt͡ʃɛrpʊʋɐte
виявляти	ʋejɐu̯ˈlʲate
владний	ˈwɫadnei̯
влаштовувати	wɫɐʃˈtɔwʊʋɐte
внесок	ˈwnɛsɔk
водоспад	wɔdɔˈspad
водій	woˈdʲii̯
волонтерка	wɔɫɔnˈtɛrkɐ
воно	wɔˈnɔ
восени	wɔseˈnɪ
воєнний	wɔˈjɛnːei̯
впевненість	ˈʍpɛu̯nenʲisʲtʲ
враження	ˈwraʒenʲːɐ
врятовувати	wrʲɐˈtɔwʊʋɐte
всесвітній	ʍsesʲˈʋʲitʲnʲii̯
втрачати	ʍtrɐˈt͡ʃate
втікач	ʍtʲiˈkat͡ʃ
вугол	ˈwuɦɔɫ
вулкан	wʊɫˈkan
вчитель	ˈʍt͡ʃɪtelʲ
вівтарний	ˈʋʲiu̯tɐrnei̯
відбуватися	ʋʲidbʊˈʋatesʲɐ
відвойовувати	ʋʲidwɔˈjɔwʊʋɐte
віддаль	ˈʋʲidːɐlʲ
відказати	ʋʲidkɐˈzate
відлічити	ʋʲidʲlʲiˈt͡ʃɪte
відмежувати	ʋʲidmeʒʊˈʋate
відношення	ʋʲidˈnɔʃenʲːɐ
відповідність	ʋʲidpɔˈʋʲidʲnʲisʲtʲ
відпустка	ʋʲidˈpustkɐ
відсутній	ʋʲid͡zˈsutʲnʲii̯
відсіч	ˈʋʲid͡zʲsʲit͡ʃ
відчинити	ʋʲid͡ʒt͡ʃeˈnɪte
віза	ˈʋʲizɐ
війна	ʋʲii̯ˈna
вільний час	ˈʋʲilʲnei̯ ˈt͡ʃas
вірити	ˈʋʲirete
вірш	ʋʲirʃ
віспа	ˈʋʲispɐ
вісімдесят три	ʋʲisʲimdeˈsʲat trɪ
вітрило	ʋʲiˈtrɪɫɔ
віяти	ˈʋʲijɐte
гадати	ɦɐˈdate
гай	ɦai̯
гаманець	ɦɐmɐˈnɛt͡sʲ
гарантувати	ɦɐrɐntʊˈʋate
гасло	ˈɦasɫɔ
гвинтівка	ɦʋenʲˈtʲiu̯kɐ
генетичний код	ɦeneˈtɪt͡ʃnei̯ kɔd
герой	ɦeˈrɔi̯
глибинний	ɦɫeˈbɪnːei̯
глухар	ɦɫʊˈxar
глід	ɦlʲid
гній	ɦnʲii̯
говорити	ɦɔwɔˈrɪte
голка	ˈɦɔɫkɐ
голод	ˈɦɔɫɔd
голубий	ɦɔɫʊˈbɪi̯
гонор	ˈɦɔnɔr
гордитися	ɦɔrˈdɪtesʲɐ
горностай	ɦɔrnɔˈstai̯
господарство	ɦɔspɔˈdarstwɔ
гостювати	ɦɔsʲtʲʊˈʋate
грабіжник	ɦrɐˈbʲiʒnek
граматика	ɦrɐˈmatekɐ
грати	ˈɦrate
грець	ɦrɛt͡sʲ
григоріанський календар	ɦreɦɔrʲiˈanʲsʲkei̯ kɐɫenˈdar
громадсько-політичний	ɦrɔˈmad͡zʲsʲkɔ pɔlʲiˈtɪt͡ʃnei̯
груба	ˈɦrubɐ
група	ˈɦrupɐ
грім	ɦrʲim
гуманізм	ɦʊmɐˈnʲizm
гусятко	ɦʊˈsʲatkɔ
гівноїд	ɦʲiu̯nɔˈjid
гідрологічний	ɦʲidrɔɫoˈɦʲit͡ʃnei̯
гіперінфляція	ɦʲiperʲinˈflʲat͡sʲijɐ
гість	ɦʲisʲtʲ
дамба	ˈdambɐ
дарувати	dɐrʊˈʋate
двадцять другий	ˈdʋad͡zʲt͡sʲɐtʲ ˈdruɦei̯
дванадцять	dʋɐˈnad͡zʲt͡sʲɐtʲ
двоголовий	dwɔɦɔˈɫɔʋei̯
двір	dʲʋʲir
де	dɛ
дев&#039;яносто	deʋjɐˈnɔstɔ
дев&#039;яносто три	deʋjɐˈnɔstɔ trɪ
дев&#039;ять	ˈdɛʋjɐtʲ
декларувати	dekɫɐrʊˈʋate
делірій	deˈlʲirʲii̯
демократ	demɔˈkrat
демонструвати	demɔnstrʊˈʋate
дерево	ˈdɛrewɔ
десерт	deˈsɛrt
деталь	deˈtalʲ
деякий	ˈdɛjɐkei̯
дзвіниця	d͡zʲʋʲiˈnɪt͡sʲɐ
дзиґар	d͡zeˈɡar
диверсія	deˈʋɛrsʲijɐ
дизайн	deˈzai̯n
дикунський	deˈkunʲsʲkei̯
дипломат	depɫɔˈmat
дискредитувати	deskredetʊˈʋate
диспетчер	deˈspɛt͡ʃːer
дитячий	deˈtʲat͡ʃei̯
добрий ранок	ˈdɔbrei̯ ˈranɔk
добросусідський	dɔbrɔsʊˈsʲid͡zʲsʲkei̯
довгоніг	dɔu̯ɦoˈnʲiɦ
довкілля	dɔu̯ˈkʲilʲːɐ
довірити	dɔˈʋʲirete
додати	dɔˈdate
дозволяти	dɔzwɔˈlʲate
долар	ˈdɔɫɐr
домен	dɔˈmɛn
допустимість	dɔpʊˈstɪmʲisʲtʲ
допізна	doˈpʲiznɐ
дорого	ˈdɔrɔɦɔ
досліджувати	dosʲˈlʲid͡ʒʊʋɐte
достовірний	dɔstɔˈʋʲirnei̯
досі	ˈdɔsʲi
доторкатися	dɔtɔrˈkatesʲɐ
дощ	dɔʃt͡ʃ
доїжджати	dɔjiʒˈd͡ʒate
другий	ˈdruɦei̯
дріт	dʲrʲit
дупа	ˈdupɐ
дурний	dʊrˈnɪi̯
дядько	ˈdʲadʲkɔ
діаметрально	dʲiɐmeˈtralʲnɔ
дід	dʲid
дійти	dʲii̯ˈtɪ
дірка	ˈdʲirkɐ
діуретичний	dʲiʊreˈtɪt͡ʃnei̯
дієта	dʲiˈjɛtɐ
еволюціонувати	ewɔlʲʊt͡sʲiɔnʊˈʋate
екваторіальний	ekʋɐtɔrʲiˈalʲnei̯
ексгібіціонізм	eɡzʲɦʲibʲit͡sʲioˈnʲizm
експеримент	ekspereˈmɛnt
експортувати	ekspɔrtʊˈʋate
електричний	eɫekˈtrɪt͡ʃnei̯
елефант	eɫeˈfant
еліпс	ˈɛlʲips
ембріональний	embrʲiɔˈnalʲnei̯
ендокринологія	endɔkrenɔˈɫɔɦʲijɐ
енциклопедія	ent͡sekɫɔˈpɛdʲijɐ
епізодичний	epʲizɔˈdɪt͡ʃnei̯
еротика	eˈrɔtekɐ
етап	eˈtap
етноґрафічний	etnɔɡrɐˈfʲit͡ʃnei̯
ж	ʒ
жалоба	ʒɐˈɫɔbɐ
жати	ˈʒate
жертва	ˈʒɛrtʋɐ
житіє	ʒetʲiˈjɛ
жовтень	ˈʒɔu̯tenʲ
жорсткий	ʒɔrstˈkɪi̯
журналіст	ʒʊrnɐˈlʲist
з&#039;їдати	zjiˈdate
заблоковувати	zɐbɫɔˈkɔwʊʋɐte
забруднити	zɐbrʊdˈnɪte
заважати	zɐʋɐˈʒate
завдяки	zɐu̯dʲɐˈkɪ
завзяття	zɐu̯ˈzʲatʲːɐ
завтрашній	ˈzau̯trɐʃnʲii̯
загибати	zɐɦeˈbate
загроза	zɐˈɦrɔzɐ
зазвичай	zɐzʋeˈt͡ʃai̯
зайвий	ˈzajʋei̯
законодавство	zɐkɔnɔˈdau̯stwɔ
закривавлений	zɐkreˈʋau̯ɫenei̯
закінчення	zɐˈkʲint͡ʃenʲːɐ
зал	zaɫ
залежний	zɐˈɫɛʒnei̯
залякати	zɐlʲɐˈkate
замах	ˈzamɐx
замок	ˈzamɔk
занепокоєння	zɐnepɔˈkɔjenʲːɐ
заощадити	zɐɔʃˈt͡ʃadete
запах	ˈzapɐx
запитати	zɐpeˈtate
заповнити	zɐˈpɔu̯nete
започаткувати	zɐpɔt͡ʃɐtkʊˈʋate
запрошувати	zɐˈprɔʃʊʋɐte
заробітний	zɐroˈbʲitnei̯
заручник	zɐˈrut͡ʃnek
засвідчувати	zɐsʲˈʋʲid͡ʒt͡ʃʊʋɐte
засновниця	zɐsˈnɔu̯net͡sʲɐ
застосовувати	zɐstɔˈsɔwʊʋɐte
заступник	zɐˈstupnek
затор	zɐˈtɔr
захисниця	zɐxesˈnɪt͡sʲɐ
захід	ˈzaxʲid
зацікавлювати	zɐt͡sʲiˈkau̯lʲʊʋɐte
збагачувати	zbɐˈɦat͡ʃʊʋɐte
збройні сили	ˈzbrɔi̯nʲi ˈsɪɫe
збіг	zʲbʲiɦ
звернутися	zʋerˈnutesʲɐ
звичайний	zʋeˈt͡ʃai̯nei̯
звужувати	ˈzwuʒʊʋɐte
звідти	ˈzʲʋʲidte
звісно	ˈzʲʋʲisnɔ
згодний	ˈzɦɔdnei̯
здатність	ˈzdatʲnʲisʲtʲ
здолати	zdɔˈɫate
зелений	zeˈɫɛnei̯
зерновий	zernɔˈʋɪi̯
зимувати	zemʊˈʋate
зловмисниця	zɫɔu̯ˈmɪsnet͡sʲɐ
злочинність	zɫɔˈt͡ʃɪnʲːisʲtʲ
зменшення	ˈzmɛnʃenʲːɐ
змушувати	ˈzmuʃʊʋɐte
зміняти	zʲmʲiˈnʲate
знак	znak
значити	ˈznat͡ʃete
зненацька	zneˈnat͡sʲkɐ
знизити	ˈznɪzete
зобов&#039;язувати	zɔbɔˈʋjazʊʋɐte
зовсім	ˈzɔu̯sʲim
зорієнтувати	zɔrʲijentʊˈʋate
зрештою	ˈzrɛʃtɔjʊ
зручність	ˈzrut͡ʃnʲisʲtʲ
зрілість	ˈzʲrʲilʲisʲtʲ
зубний	zʊbˈnɪi̯
зупиняти	zʊpeˈnʲate
зцілити	zʲt͡sʲiˈɫɪte
зібрати	zʲiˈbrate
зіставляти	zʲistɐu̯ˈlʲate
ирод	ˈɪrɔd
йод	jɔd
каблучка	kɐˈbɫut͡ʃkɐ
казати	kɐˈzate
каліграфія	kɐlʲiˈɦrafʲijɐ
кам&#039;яний	kɐmjɐˈnɪi̯
канадець	kɐˈnadet͡sʲ
канчук	kɐnˈt͡ʃuk
капуста	kɐˈpustɐ
кардіологічний	kɐrdʲiɔɫoˈɦʲit͡ʃnei̯
карта	ˈkartɐ
касувати	kɐsʊˈʋate
католицький	kɐtɔˈɫɪt͡sʲkei̯
качка	ˈkat͡ʃkɐ
квадрат	kʋɐˈdrat
келих	ˈkɛɫex
кипіти	keˈpʲite
кит	kɪt
кишеньковий злодій	keʃenʲˈkɔʋei̯ ˈzɫɔdʲii̯
класичний	kɫɐˈsɪt͡ʃnei̯
клоччя	ˈkɫɔt͡ʃʲːɐ
клініка	ˈklʲinʲikɐ
кнайпа	ˈknai̯pɐ
князь	knʲazʲ
кобила	kɔˈbɪɫɐ
ковтун	kɔu̯ˈtun
кожному своє	ˈkɔʒnɔmʊ swɔˈjɛ
коктейль Молотова	kɔkˈtɛi̯lʲ ˈmɔɫɔtɔʋɐ
колесо	ˈkɔɫesɔ
колода	kɔˈɫɔdɐ
комедія	kɔˈmɛdʲijɐ
комп&#039;ютеризація	kɔmpjʊtereˈzat͡sʲijɐ
компетенція	kɔmpeˈtɛnʲt͡sʲijɐ
комунікація	kɔmʊnʲiˈkat͡sʲijɐ
комір	ˈkɔmʲir
кондитер	kɔnˈdɪter
конкуренція	kɔnkʊˈrɛnʲt͡sʲijɐ
консервація	kɔnserˈʋat͡sʲijɐ
консультантка	kɔnsʊlʲˈtantkɐ
контрастувати	kɔntrɐstʊˈʋate
конференція	kɔnfeˈrɛnʲt͡sʲijɐ
концепт	kɔnˈt͡sɛpt
координувати	kɔɔrdenʊˈʋate
кора	kɔˈra
корзина	kɔrˈzɪnɐ
кориця	kɔˈrɪt͡sʲɐ
королева	kɔrɔˈɫɛʋɐ
коротше кажучи	kɔˈrɔt͡ʃʃe ˈkaʒʊt͡ʃe
косметичний	kɔsmeˈtɪt͡ʃnei̯
костел	kɔˈstɛɫ
коханець	kɔˈxanet͡sʲ
коштовний	kɔʃˈtɔu̯nei̯
красуня	krɐˈsunʲɐ
країна	krɐˈjinɐ
крейсер	ˈkrɛi̯ser
кречет	ˈkrɛt͡ʃet
криза	ˈkrɪzɐ
критика	ˈkrɪtekɐ
кровожерливий	krɔwɔˈʒɛrɫeʋei̯
кросівка	kroˈsʲiu̯kɐ
кудись	kʊˈdɪsʲ
культ	kulʲt
купа	ˈkupɐ
кур&#039;єр	kʊˈrjɛr
куртка	ˈkurtkɐ
кухарка	kʊˈxarkɐ
кібернетичний	kʲiberneˈtɪt͡ʃnei̯
кількість	ˈkʲilʲkʲisʲtʲ
кімоно	kʲimɔˈnɔ
кір	kʲir
лаваш	ɫɐˈʋaʃ
ламати	ɫɐˈmate
ласкавий	ɫɐˈskaʋei̯
лебідь	ˈɫɛbʲidʲ
легітимний	ɫeɦʲiˈtɪmnei̯
ледар	ˈɫɛdɐr
лижник	ˈɫɪʒnek
лис	ɫɪs
лицар	ˈɫɪt͡sɐr
логіка	ˈɫɔɦʲikɐ
локон	ˈɫɔkɔn
лось	ɫɔsʲ
любителька	lʲʊˈbɪtelʲkɐ
людський	lʲʊd͡zʲˈsʲkɪi̯
лялька	ˈlʲalʲkɐ
ліберал	lʲibeˈraɫ
лігво	ˈlʲiɦwɔ
ліки	ˈlʲike
лінивий	lʲiˈnɪʋei̯
літак	lʲiˈtak
літр	lʲitr
м&#039;ясо	ˈmjasɔ
магнетизм	mɐɦneˈtɪzm
майно	mɐi̯ˈnɔ
макарони	mɐkɐˈrɔne
малярство	mɐˈlʲarstwɔ
мандрувати	mɐndrʊˈʋate
маргіналізація	mɐrɦʲinɐlʲiˈzat͡sʲijɐ
мармур	ˈmarmʊr
маршрут	mɐrʃˈrut
масть	masʲtʲ
матрац	mɐˈtrat͡s
мегаліт	meɦɐˈlʲit
медовий місяць	meˈdɔʋei̯ ˈmʲisʲɐt͡sʲ
мексиканка	mekseˈkankɐ
мене звати	meˈnɛ ˈzʋate
менше	ˈmɛnʃe
месіанський	mesʲiˈanʲsʲkei̯
металургійний	metɐɫʊrˈɦʲii̯nei̯
методичний	metɔˈdɪt͡ʃnei̯
мешканець	ˈmɛʃkɐnet͡sʲ
милосердий	meɫɔˈsɛrdei̯
мир	mɪr
мисливиця	mesˈɫɪʋet͡sʲɐ
мить	mɪtʲ
мнякий	mnʲɐˈkɪi̯
мова	ˈmɔʋɐ
модрина	mɔˈdrɪnɐ
молодиця	mɔɫɔˈdɪt͡sʲɐ
монохромний	mɔnɔˈxrɔmnei̯
морквяний	mɔrkˈʋʲanei̯
мотоцикл	mɔtɔˈt͡sɪkɫ
мужній	ˈmuʒnʲii̯
муніципальний	mʊnʲit͡seˈpalʲnei̯
мусульманство	mʊsʊlʲˈmanstwɔ
мігрень	mʲiˈɦrɛnʲ
міжконфесійний	mʲiʒkɔnfeˈsʲii̯nei̯
мізантропія	mʲizɐnˈtrɔpʲijɐ
мікрохвильовка	mʲikrɔxʋeˈlʲɔu̯kɐ
мільйонер	mʲilʲjɔˈnɛr
мінімальна заробітна плата	mʲinʲiˈmalʲnɐ zɐroˈbʲitnɐ ˈpɫatɐ
містобудування	mʲistɔbʊdʊˈʋanʲːɐ
місіонер	mʲisʲiɔˈnɛr
мітинг	ˈmʲitenɦ
міхур	mʲiˈxur
набій	nɐˈbʲii̯
навколишнє середовище	nɐu̯ˈkɔɫeʃnʲe sereˈdɔʋeʃt͡ʃe
навігаційний	nɐʋʲiɦɐˈt͡sʲii̯nei̯
нагляд	ˈnaɦlʲɐd
надворі	nɐdˈwɔrʲi
надлюдський	nɐdʲˈlʲud͡zʲsʲkei̯
надійність	nɐˈdʲii̯nʲisʲtʲ
названий	ˈnazʋɐnei̯
найменше	nɐi̯ˈmɛnʃe
належати	nɐˈɫɛʒɐte
наочний	nɐˈɔt͡ʃnei̯
наполегливість	nɐpɔˈɫɛɦɫeʋʲisʲtʲ
напружувати	nɐˈpruʒʊʋɐte
нарешті	nɐˈrɛʃtʲi
народжувати	nɐˈrɔd͡ʒʊʋɐte
насміхатися	nɐsʲmʲiˈxatesʲɐ
настроїти	nɐˈstrɔjite
насіння	nɐˈsʲinʲːɐ
натомість	nɐˈtɔmʲisʲtʲ
нафта	ˈnaftɐ
начальство	nɐˈt͡ʃalʲstwɔ
небо	ˈnɛbɔ
невимовний	neʋeˈmɔu̯nei̯
неврологія	neu̯rɔˈɫɔɦʲijɐ
невіста	neˈʋʲistɐ
недавній	neˈdau̯nʲii̯
недорозвинений	nedɔrɔzˈʋɪnenei̯
недоторканий	nedɔˈtɔrkɐnei̯
незалежність	nezɐˈɫɛʒnʲisʲtʲ
нездоланний	nezdɔˈɫanːei̯
незрілість	nezʲˈrʲilʲisʲtʲ
нейтральний	nei̯ˈtralʲnei̯
немалий	nemɐˈɫɪi̯
ненаголошений	nenɐɦɔˈɫɔʃenei̯
необґрунтований	ɔbɡrʊnˈtɔʋɐnei̯
неофіційний	neɔfʲiˈt͡sʲii̯nei̯
непитущий	nepeˈtuʃt͡ʃei̯
непотрібний	nepoˈtʲrʲibnei̯
непридатний	nepreˈdatnei̯
нерегулярність	nereɦʊˈlʲarnʲisʲtʲ
нескінченність	nesʲkʲinˈt͡ʃɛnʲːisʲtʲ
несправедливий	nesprɐʋedˈɫɪʋei̯
несумісний	nesʊˈmʲisnei̯
неформальний	nefɔrˈmalʲnei̯
нещодавній	neʃt͡ʃɔˈdau̯nʲii̯
неіснування	neisnʊˈʋanʲːɐ
нині	ˈnɪnʲi
новаторство	nɔˈʋatɔrstwɔ
новорічний	nɔwoˈrʲit͡ʃnei̯
номер	ˈnɔmer
носій	noˈsʲii̯
ноші	ˈnɔʃʲi
нутрощі	ˈnutrɔʃt͡ʃʲi
ніколи	nʲiˈkɔɫe
німка	ˈnʲimkɐ
ніщо	nʲiʃˈt͡ʃɔ
об&#039;єднати	ɔbjedˈnate
обговорити	ɔbɦɔwɔˈrɪte
обеззброювати	ɔbezːˈbrɔjʊʋɐte
обласний	ɔbɫɐsˈnɪi̯
обмежений	ɔbˈmɛʒenei̯
оборонити	ɔbɔrɔˈnɪte
обрати	ɔˈbrate
обстріл	ˈɔbstʲrʲiɫ
обчислювати	ɔbˈt͡ʃɪsʲlʲʊʋɐte
обідати	oˈbʲidɐte
овечка	ɔˈʋɛt͡ʃkɐ
огляд	ˈɔɦlʲɐd
оден	ɔˈdɛn
одинадцять	ɔdeˈnad͡zʲt͡sʲɐtʲ
однокласник	ɔdnɔˈkɫasnek
однорідний	ɔdnoˈrʲidnei̯
одношлюбний	ɔdnoʃˈlʲubnei̯
ожина	ɔˈʒɪnɐ
ознайомлення	ɔznɐˈjɔmɫenʲːɐ
оксамит	ɔksɐˈmɪt
олігархія	ɔlʲiˈɦarxʲijɐ
онколог	ɔnˈkɔɫɔɦ
опариш	ɔˈpareʃ
оплачувати	ɔˈpɫat͡ʃʊʋɐte
опортуністка	ɔpɔrtʊˈnʲistkɐ
опублікувати	ɔpʊblʲikʊˈʋate
організатор	ɔrɦɐnʲiˈzatɔr
органічна хімія	ɔrɦɐˈnʲit͡ʃnɐ ˈxʲimʲijɐ
орнітологічний	ɔrnʲitɔɫoˈɦʲit͡ʃnei̯
освіта	ɔsʲˈʋʲitɐ
осиротіти	ɔseroˈtʲite
основоположний	ɔsnɔwɔpɔˈɫɔʒnei̯
осоромлювати	ɔsɔˈrɔmlʲʊʋɐte
отже	ˈɔdʒe
офігенний	ɔfʲiˈɦɛnːei̯
охорона	ɔxɔˈrɔnɐ
оцет	ˈɔt͡set
очиці	ɔˈt͡ʃɪt͡sʲi
п&#039;ятдесят один	pjɐddeˈsʲat ɔˈdɪn
п&#039;ятнадцятий	pjɐtˈnad͡zʲt͡sʲɐtei̯
п&#039;єса	ˈpjɛsɐ
павза	ˈpau̯zɐ
палестинець	pɐɫeˈstɪnet͡sʲ
палка	ˈpaɫkɐ
паморозь	ˈpamɔrɔzʲ
пандемічний	pɐndeˈmʲit͡ʃnei̯
паразит	pɐrɐˈzɪt
парижанин	pɐreˈʒanen
парниковий ефект	pɐrneˈkɔʋei̯ eˈfɛkt
партнер	pɐrtˈnɛr
пасажирка	pɐsɐˈʒɪrkɐ
патент	pɐˈtɛnt
патріотизм	pɐtʲrʲiɔˈtɪzm
пацюк	pɐˈt͡sʲuk
пекарка	ˈpɛkɐrkɐ
пенсіонерка	penʲsʲiɔˈnɛrkɐ
перебороти	perebɔˈrɔte
переважати	pereʋɐˈʒate
перевантажувати	pereʋɐnˈtaʒʊʋɐte
перевиховувати	pereʋeˈxɔwʊʋɐte
перед	ˈpɛred
передвиборчий	peredˈʋɪbɔrt͡ʃei̯
передувати	peredʊˈʋate
перезаписувати	perezɐˈpɪsʊʋɐte
перекотиполе	perekɔˈtɪpɔɫe
перемога	pereˈmɔɦɐ
переорієнтація	pereɔrʲijenˈtat͡sʲijɐ
перепросити	pereprɔˈsɪte
переселенка	pereseˈɫɛnkɐ
перетворити	peretwɔˈrɪte
перечитувати	pereˈt͡ʃɪtʊʋɐte
перспективний	perspekˈtɪu̯nei̯
першомучениця	perʃoˈmut͡ʃenet͡sʲɐ
періодично	perʲiɔˈdɪt͡ʃnɔ
пизда	pezˈda
письменність	pesʲˈmɛnʲːisʲtʲ
пити	ˈpɪte
плакат	pɫɐˈkat
платіж	pɫɐˈtʲiʒ
плем&#039;я	ˈpɫɛmjɐ
плоть	pɫɔtʲ
пляж	plʲaʒ
пов&#039;язувати	pɔˈʋjazʊʋɐte
повезти	pɔʋezˈtɪ
повноваження	pɔu̯nɔˈʋaʒenʲːɐ
повстанець	pɔu̯ˈstanet͡sʲ
повх	pɔu̯x
повісити	pɔˈʋʲisete
поглинати	pɔɦɫeˈnate
погроза	pɔˈɦrɔzɐ
податок	pɔˈdatɔk
подолання	pɔdɔˈɫanʲːɐ
подякувати	pɔˈdʲakʊʋɐte
позавчора	pɔzɐu̯ˈt͡ʃɔrɐ
поздоровляти	pɔzdɔrɔu̯ˈlʲate
познайомитися	pɔznɐˈjɔmetesʲɐ
показати	pɔkɐˈzate
покоління	pɔkoˈlʲinʲːɐ
поламати	pɔɫɐˈmate
полон	pɔˈɫɔn
польський	ˈpɔlʲsʲkei̯
поліглот	pɔlʲiˈɦɫɔt
політизація	pɔlʲiteˈzat͡sʲijɐ
помешкання	pɔˈmɛʃkɐnʲːɐ
помітити	poˈmʲitete
понеділковий	pɔneˈdʲiɫkɔʋei̯
попри	ˈpɔpre
попільничка	pɔpʲilʲˈnɪt͡ʃkɐ
порекомендувати	pɔrekɔmendʊˈʋate
пороховий	pɔrɔxɔˈʋɪi̯
порушення	poˈruʃenʲːɐ
порівнювати	poˈrʲiu̯nʲʊʋɐte
посада	pɔˈsadɐ
посередниця	pɔseˈrɛdnet͡sʲɐ
поскаржитися	pɔˈskarʒetesʲɐ
посміхнутися	pɔsʲmʲixˈnutesʲɐ
поспішний	poˈsʲpʲiʃnei̯
поставити	pɔˈstaʋete
постачити	pɔˈstat͡ʃete
посуха	poˈsuxɐ
поточний	pɔˈtɔt͡ʃnei̯
потягнути	pɔtʲɐɦˈnute
походження	pɔˈxɔd͡ʒenʲːɐ
початківець	pɔt͡ʃɐtʲˈkʲiʋet͡sʲ
почувати	pɔt͡ʃʊˈʋate
пошук	ˈpɔʃʊk
поїзд	ˈpɔjizd
прабаба	prɐˈbabɐ
право	ˈprawɔ
правоохоронний	prɐwɔɔxɔˈrɔnːei̯
прагнення	ˈpraɦnenʲːɐ
практичний	prɐkˈtɪt͡ʃnei̯
праслов&#039;янський	prɐsɫɔˈʋjanʲsʲkei̯
праця	ˈprat͡sʲɐ
презентація	prezenˈtat͡sʲijɐ
прелюдія	preˈlʲudʲijɐ
прибуток	preˈbutɔk
привабливість	preˈʋabɫeʋʲisʲtʲ
приводити	preˈwɔdete
приголомшливий	preɦɔˈɫɔmʃɫeʋei̯
придумувати	preˈdumʊʋɐte
призма	ˈprɪzmɐ
прийнятність	prei̯ˈnʲatʲnʲisʲtʲ
прикрасити	preˈkrasete
приманити	premɐˈnɪte
принести	preneˈstɪ
принциповий	prent͡seˈpɔʋei̯
припускати	prepʊˈskate
приручати	prerʊˈt͡ʃate
прислухатися	presɫʊˈxatesʲɐ
присудок	ˈprɪsʊdɔk
притягти	pretʲɐɦˈtɪ
причинно-наслідковий	preˈt͡ʃɪnːɔ nɐsʲlʲidˈkɔʋei̯
приєднатися	prejedˈnatesʲɐ
приїхати	preˈjixɐte
пробувати	ˈprɔbʊʋɐte
провакцинувати	prɔʋɐkt͡senʊˈʋate
прогнозувати	prɔɦnɔzʊˈʋate
програш	ˈprɔɦrɐʃ
продовження	prɔˈdɔu̯ʒenʲːɐ
прожити	prɔˈʒɪte
прокремлівський	prɔkremˈlʲiu̯sʲkei̯
промисловість	prɔmesˈɫɔʋʲisʲtʲ
пропаганда	prɔpɐˈɦandɐ
пророк	prɔˈrɔk
простежити	prɔˈstɛʒete
простота	prɔstɔˈta
протидія	prɔteˈdʲijɐ
протиракетний	prɔterɐˈkɛtnei̯
профіль	ˈprɔfʲilʲ
процвітаючий	prɔt͡sʲʋʲiˈtajʊt͡ʃei̯
проявити	prɔjɐˈʋɪte
проігнорувати	prɔiɦnɔrʊˈʋate
психопатичний	psexɔpɐˈtɪt͡ʃnei̯
психіатричний	psexʲiɐˈtrɪt͡ʃnei̯
пугач	ˈpuɦɐt͡ʃ
пустиня	pʊˈstɪnʲɐ
пюпітр	pʲʊˈpʲitr
південноамериканський	pʲiu̯denːɔɐmereˈkanʲsʲkei̯
північноатлантичний	pʲiu̯nʲit͡ʃnɔɐtɫɐnˈtɪt͡ʃnei̯
підвечірок	pʲidʋeˈt͡ʃʲirɔk
піддашшя	pʲiˈdːaʃʲːɐ
підкреслювати	pʲidˈkrɛsʲlʲʊʋɐte
підміняти	pʲidʲmʲiˈnʲate
підпис	ˈpʲidpes
підприємство	pʲidpreˈjɛmstwɔ
підтверджувати	pʲidtˈʋɛrd͡ʒʊʋɐte
пізній	ˈpʲizʲnʲii̯
пінистий	ˈpʲinestei̯
після	ˈpʲisʲlʲɐ
піхота	pʲiˈxɔtɐ
радикалізація	rɐdekɐlʲiˈzat͡sʲijɐ
радіоактивний	ˌradʲiɔɐkˈtɪu̯nei̯
рало	ˈraɫɔ
раса	ˈrasɐ
рація	ˈrat͡sʲijɐ
реабілітація	reɐbʲilʲiˈtat͡sʲijɐ
реанімація	reɐnʲiˈmat͡sʲijɐ
революція	rewoˈlʲut͡sʲijɐ
редактор	reˈdaktɔr
реконструювати	rekɔnstrʊjʊˈʋate
ремісник	remʲisˈnɪk
республіка	reˈspublʲikɐ
рецесія	reˈt͡sɛsʲijɐ
рибка	ˈrɪbkɐ
ринок	ˈrɪnɔk
робітник	rɔbʲitˈnɪk
родзинка	rɔˈd͡zɪnkɐ
родовище	rɔˈdɔʋeʃt͡ʃe
розбирати	rɔzbeˈrate
розважальний	rɔzʋɐˈʒalʲnei̯
розгромити	rɔzɦrɔˈmɪte
роздягти	rɔzʲdʲɐɦˈtɪ
розлити	rɔzˈɫɪte
розмішувати	rozʲˈmʲiʃʊʋɐte
розповсюдження	rɔzpɔu̯ˈsʲud͡ʒenʲːɐ
розпродавати	rɔzprɔdɐˈʋate
розпізнавання	rɔzʲpʲiznɐˈʋanʲːɐ
розслідувати	rozsʲˈlʲidʊʋɐte
розумний дім	roˈzumnei̯ dʲim
розшифровувати	rɔʒʃeˈfrɔwʊʋɐte
ростити	rɔˈstɪte
руйнівний	rʊi̯nʲiu̯ˈnɪi̯
русин	ˈrusen
рутинний	rʊˈtɪnːei̯
рівномірний	rʲiu̯noˈmʲirnei̯
рідкий	rʲidˈkɪi̯
різкий	rʲizˈkɪi̯
різнорідний	rʲiznoˈrʲidnei̯
рішення	ˈrʲiʃenʲːɐ
с	s
саботажник	sɐbɔˈtaʒnek
садистичний	sɐdeˈstɪt͡ʃnei̯
салон	sɐˈɫɔn
самовпевненість	sɐmɔu̯ˈpɛu̯nenʲisʲtʲ
самодостатній	sɐmɔdɔˈstatʲnʲii̯
самокат	sɐmɔˈkat
самостійність	sɐmoˈsʲtʲii̯nʲisʲtʲ
санітарний	sɐnʲiˈtarnei̯
сарна	ˈsarnɐ
сват	sʋat
своєрідний	swɔjeˈrʲidnei̯
священик	sʲʋʲɐʃˈt͡ʃɛnek
свідок	ˈsʲʋʲidɔk
світлина	sʲʋʲitˈɫɪnɐ
секрет	seˈkrɛt
сектор	ˈsɛktɔr
селянський	seˈlʲanʲsʲkei̯
сербохорватський	serbɔxɔrˈʋat͡sʲkei̯
середа	sereˈda
серп	sɛrp
сестрин	seˈstrɪn
сидіти	seˈdʲite
символічний	semwoˈlʲit͡ʃnei̯
синагога	senɐˈɦɔɦɐ
синтетичний	senteˈtɪt͡ʃnei̯
система	seˈstɛmɐ
сказати	skɐˈzate
скасувати	skɐsʊˈʋate
склад	skɫad
склянка	ˈsklʲankɐ
скоротити	skɔrɔˈtɪte
скульптор	ˈskulʲptɔr
слава Ісусу Христу	ˈsɫaʋɐ iˈsusʊ xreˈstu
слина	ˈsɫɪnɐ
словенський	sɫɔˈʋɛnʲsʲkei̯
службовий	sɫʊʒˈbɔʋei̯
сльоза	sʲlʲɔˈza
слідство	ˈsʲlʲid͡zstwɔ
смарагдовий	smɐˈraɦdɔʋei̯
смертний	ˈsmɛrtnei̯
смутний	smʊtˈnɪi̯
сміття	sʲmʲiˈtʲːa
снодійний	snoˈdʲii̯nei̯
сокіл	ˈsɔkʲiɫ
соня	ˈsɔnʲɐ
сорок	ˈsɔrɔk
сорок шість	ˈsɔrɔk ʃʲisʲtʲ
сосна	sɔsˈna
соціальний	sɔt͡sʲiˈalʲnei̯
спам	spam
сперечатися	spereˈt͡ʃatesʲɐ
специфікувати	spet͡sefʲikʊˈʋate
сплатити	spɫɐˈtɪte
сподівання	spɔdʲiˈʋanʲːɐ
спойлер	ˈspɔi̯ɫer
сполучити	spɔɫʊˈt͡ʃɪte
спортсмен	spɔrt͡sˈmɛn
спостереження	spɔsteˈrɛʒenʲːɐ
сприймати	sprei̯ˈmate
спровокувати	sprɔwɔkʊˈʋate
спрямовувати	sprʲɐˈmɔwʊʋɐte
співвітчизник	sʲpʲiʋʲːiˈt͡ʃːɪznek
співпереживати	sʲpʲiu̯pereʒeˈʋate
співчутливий	sʲpʲiu̯t͡ʃʊtˈɫɪʋei̯
співіснувати	sʲpʲiʋʲisnʊˈʋate
спір	sʲpʲir
срати	ˈsrate
ставити	ˈstaʋete
стандартизація	stɐndɐrteˈzat͡sʲijɐ
старик	stɐˈrɪk
статут	stɐˈtut
стежити	ˈstɛʒete
сто	stɔ
стомити	stɔˈmɪte
стояння	stɔˈjanʲːɐ
страйк	strai̯k
страшенно	strɐˈʃɛnːɔ
стримати	ˈstrɪmɐte
студентка	stʊˈdɛntkɐ
стільки	ˈsʲtʲilʲke
субсидія	sʊbˈsɪdʲijɐ
судак	sʊˈdak
судовий	sʊdɔˈʋɪi̯
сумарний	sʊˈmarnei̯
сумувати	sʊmʊˈʋate
супроводжувати	sʊprɔˈwɔd͡ʒʊʋɐte
суспільство	sʊˈsʲpʲilʲstwɔ
сусід	sʊˈsʲid
суцвіття	sʊt͡sʲˈʋʲitʲːɐ
сфера	ˈsfɛrɐ
схвальний	ˈsxʋalʲnei̯
сховище	ˈsxɔʋeʃt͡ʃe
сьогодення	sʲɔɦɔˈdɛnʲːɐ
сім&#039;я	ˈsʲimjɐ
сімдесят шість	sʲimdeˈsʲat ʃʲisʲtʲ
сіни	ˈsʲine
т	t
таблиця	tɐˈbɫɪt͡sʲɐ
таксі	tɐkˈsʲi
тамада	tɐmɐˈda
татко	ˈtatkɔ
твердиня	tʋerˈdɪnʲɐ
текти	tekˈtɪ
телескоп	teɫeˈskɔp
темниця	temˈnɪt͡sʲɐ
теоретик	teɔˈrɛtek
терапевтичний	terɐpeu̯ˈtɪt͡ʃnei̯
термінологія	termʲinɔˈɫɔɦʲijɐ
терор	teˈrɔr
тестування	testʊˈʋanʲːɐ
технологія	texnɔˈɫɔɦʲijɐ
тимчасово	temt͡ʃɐˈsɔwɔ
титар	ˈtɪtɐr
тлумач	tɫʊˈmat͡ʃ
товаришка	tɔˈʋareʃkɐ
токар	ˈtɔkɐr
топір	toˈpʲir
торкати	tɔrˈkate
точка зору	ˈtɔt͡ʃkɐ ˈzɔrʊ
трав&#039;яний	trɐʋjɐˈnɪi̯
традиційний	trɐdeˈt͡sʲii̯nei̯
трансплантація	trɐnspɫɐnˈtat͡sʲijɐ
треба	ˈtrɛbɐ
три	trɪ
тридцятий	tred͡zʲˈt͡sʲatei̯
тридцять сім	ˈtrɪd͡zʲt͡sʲɐtʲ sʲim
трирічний	treˈrʲit͡ʃnei̯
труп	trup
труїти	trʊˈjite
туз	tuz
туризм	tʊˈrɪzm
туфля	ˈtuflʲɐ
тяжкий	tʲɐʒˈkɪi̯
тітка	ˈtʲitkɐ
ув&#039;язнення	ʊˈʋjaznenʲːɐ
угода	ʊˈɦɔdɐ
узаконювати	ʊzɐˈkɔnʲʊʋɐte
українець	ʊkrɐˈjinet͡sʲ
українською	ʊkrɐˈjinʲsʲkɔjʊ
умерти	ʊˈmɛrte
універсальний	ʊnʲiʋerˈsalʲnei̯
уособити	ʊɔˈsɔbete
упорядковувати	ʊpɔrʲɐdˈkɔwʊʋɐte
урбанізувати	ʊrbɐnʲizʊˈʋate
усе	ˈuse
уста	ʊˈsta
утворення	ʊtˈwɔrenʲːɐ
ухвала	ʊxˈʋaɫɐ
учителька	ʊˈt͡ʃɪtelʲkɐ
файний	ˈfai̯nei̯
фанатизм	fɐnɐˈtɪzm
фарфор	ˈfarˈfɔr
федерація	fedeˈrat͡sʲijɐ
ферзь	fɛrzʲ
фонд	fɔnd
фортеця	fɔrˈtɛt͡sʲɐ
фрагмент	frɐɦˈmɛnt
фруктовий сік	frʊkˈtɔʋei̯ sʲik
фюзеляж	fʲʊzeˈlʲaʒ
фізіолог	fʲizʲiˈɔɫɔɦ
філологічний	fʲiɫɔɫoˈɦʲit͡ʃnei̯
фінський ніж	ˈfʲinʲsʲkei̯ ˈniʒ
фінік	ˈfʲinʲik
хабар	xɐˈbar
характерний	xɐrɐkˈtɛrnei̯
хворіти	xwoˈrʲite
хвіст	xʋʲist
хліб	xlʲib
холоднокровний	xɔɫɔdnɔˈkrɔu̯nei̯
хотітися	xoˈtʲitesʲɐ
християнин	xresteˈjanen
хтивий	ˈxtɪʋei̯
хуйло	xʊi̯ˈɫɔ
цвіль	ˈt͡sʋilʲ
целакант	t͡seɫɐˈkant
церемоніальний	t͡seremɔnʲiˈalʲnei̯
цигарка	t͡seˈɦarkɐ
цифра	ˈt͡sɪfrɐ
цуценя	t͡sʊt͡seˈnʲa
цілісність	ˈt͡sʲilʲisʲnʲisʲtʲ
цінність	ˈt͡sʲinʲːisʲtʲ
чад	t͡ʃad
чародій	t͡ʃɐroˈdʲii̯
часто	ˈt͡ʃastɔ
чемний	ˈt͡ʃɛmnei̯
червневий	t͡ʃerwˈnɛʋei̯
черепаха	t͡ʃereˈpaxɐ
чесний	ˈt͡ʃɛsnei̯
чин	t͡ʃɪn
численний	t͡ʃesˈɫɛnːei̯
член	t͡ʃɫɛn
чоловічий рід	t͡ʃɔɫɔˈʋʲit͡ʃei̯ ˈrid
чорнобривий	t͡ʃɔrnɔˈbrɪʋei̯
чорт забирай	t͡ʃɔrt zɐbeˈrai̯
чудій	t͡ʃʊˈdʲii̯
чума	t͡ʃʊˈma
шантаж	ʃɐnˈtaʒ
шахівниця	ʃɐxʲiu̯ˈnɪt͡sʲɐ
швейцарський	ʃʋei̯ˈt͡sarsʲkei̯
шено	ˈʃɛnɔ
шестиповерховий	ʃestepɔʋerˈxɔʋei̯
широкосмуговий	ʃerɔkɔsmʊɦɔˈʋɪi̯
шкода	ˈʃkɔdɐ
шлях	ʃlʲax
шовковистий	ʃɔu̯kɔˈʋɪstei̯
шопінг	ˈʃɔpʲinɦ
штрафувати	ʃtrɐfʊˈʋate
шістдесят	ʃʲizdeˈsʲat
шістдесятий	ʃʲizdeˈsʲatei̯
щелепа	ˈʃt͡ʃɛɫepɐ
що	ʃt͡ʃɔ
щока	ʃt͡ʃɔˈka
щука	ˈʃt͡ʃukɐ
щі	ʃt͡ʃʲi
юшка	ˈjuʃkɐ
яблуко розбрату	ˈjabɫʊkɔ ˈrɔzbrɐtʊ
ядерна війна	ˈjadernɐ ʋʲii̯ˈna
як тільки	jak ˈtʲilʲke
якийсь	jɐˈkɪi̯sʲ
яничар	jɐneˈt͡ʃar
ярус	ˈjarʊs
ящик	ˈjaʃt͡ʃek
є	jɛ
єврейка	jeu̯ˈrɛi̯kɐ
єдваб	jedˈʋab
єр	jɛr
ігролад	iɦrɔˈɫad
ідеалістичний	ideɐlʲiˈstɪt͡ʃnei̯
ізгинути	izˈɦɪnʊte
імбирний	imˈbɪrnei̯
імператриця	imperɐˈtrɪt͡sʲɐ
імунізувати	imʊnʲizʊˈʋate
інавгурація	inɐu̯ɦʊˈrat͡sʲijɐ
індивідуально	indeʋʲidʊˈalʲnɔ
індійка	inʲˈdʲii̯kɐ
інженер	inʒeˈnɛr
інновація	inːɔˈʋat͡sʲijɐ
інспекція	inˈspɛkt͡sʲijɐ
інтегрувати	inteɦrʊˈʋate
інтенсивність	intenˈsɪu̯nʲisʲtʲ
інтермецо	interˈmɛt͡sɔ
інфекційний	infekˈt͡sʲii̯nei̯
інцидент	int͡seˈdɛnt
ірландець	irˈɫandet͡sʲ
ісландець	isˈɫandet͡sʲ
істеричний	isteˈrɪt͡ʃnei̯
італійка	itɐˈlʲii̯kɐ
їден	jiˈdɛn
їсти	ˈjiste
ґвалт	ɡʋaɫt
ґерлиґа	ɡerˈɫɪɡɐ
ґоґель-моґель	ˈɡɔɡelʲ ˈmɔɡelʲ
ґудзик	ˈɡud͡zek
