We are going to solemnly compare the evolution between greek and greek*****

akis   ->    akis
ɛna   ->    ɛna
is   ->    is
llo   ->    llo
tatos   ->    tatɤs
os   ->    ɤs
ɛɡɛ   ->    ɛɡɛ
ɛɡistʰos   ->    ɛɡistʰɤs
ɛtʰalos   ->    ɛtʰalɤs
ɛolos   ->    ɛɤlɤs
awɡias   ->    awɡias
awlis   ->    awlis
aʍtonoe   ->    aʍtɤnoe
aʍksumon   ->    aʍksumɤn
baal   ->    baal
balbura   ->    balbura
bɛrɡa   ->    bɛrɡa
baktria   ->    baktria
betriakon   ->    betriakɤn
byotos   ->    byɤtɤs
bottiɛy   ->    bɤttiɛy
budion   ->    budiɤn
brɛnɛ   ->    brɛnɛ
brawron   ->    brawrɤn
breʍky   ->    breʍky
bryklike   ->    bryklike
byznɛy   ->    byznɛy
bolkon   ->    bɤlkɤn
bosporos   ->    bɤspɤrɤs
ɡabriel   ->    ɡabriel
ɡatʰɛɛ   ->    ɡatʰɛɛ
ɡɛnnesarɛt   ->    ɡɛnnesarɛt
ɡɛrenios   ->    ɡɛreniɤs
ɡeryonas   ->    keryɤnas
ɡolɡotʰa   ->    ɡɤlɡɤtʰa
ɡorɡias   ->    ɡɤrɡias
ɡorillɛ   ->    ɡɤrillɛ
dapʰne   ->    dapʰne
dipɛa   ->    dipɛa
dirpʰys   ->    dirpʰys
dadakes   ->    dadakes
damaskos   ->    damaskɤs
ðanaβi   ->    ðanaβi
dinolokʰos   ->    dinɤlokʰɤs
deʍs   ->    deʍs
demaratos   ->    demaratɤs
demoklides   ->    demoklides
demopʰilos   ->    demopʰilɤs
derusiɛy   ->    derusiɛy
dionysios   ->    diɤnysiɤs
dioskuros   ->    diɤskurɤs
domitios   ->    domitiɤs
drilon   ->    drilɤn
dorimakʰos   ->    dɤrimakʰɤs
ilitʰya   ->    ilitʰya
eʍtʰymɛnes   ->    eʍtʰymɛnes
eʍkles   ->    eʍkles
ewrykles   ->    ewrykles
ewropa   ->    ewropa
eʍkʰenor   ->    eʍkʰenɤr
ewmɛos   ->    ewmɛɤs
zaŋkle   ->    zaŋkle
zan   ->    zan
zbɛltʰiurdos   ->    zbɛltʰiurdɤs
zɛlpʰa   ->    zɛlpʰa
zekas   ->    zekas
zenobios   ->    zenobiɤs
tʰarybis   ->    tʰarybis
tʰapsakos   ->    tʰapsakɤs
tʰɛmis   ->    tʰɛmis
tʰɛoɡnis   ->    tʰɛoɡnis
tʰɛrme   ->    tʰɛrme
tʰizbe   ->    tʰizbe
tʰɛsprotos   ->    tʰɛsprɤtɤs
tʰɛopʰrastos   ->    tʰɛopʰrastɤs
tʰeramɛnes   ->    tʰeramɛnes
tʰukydides   ->    tʰukydides
tʰraks   ->    tʰraks
tʰreks   ->    tʰreks
kabiry   ->    kabiry
kalkʰas   ->    kalkʰas
kamiros   ->    kamirɤs
kantabry   ->    kantabry
karbon   ->    karbɤn
karussa   ->    karussa
karpis   ->    karpis
kastabos   ->    kastabɤs
katon   ->    katɤn
kain   ->    kain
kɛrkyra   ->    kɛrkyra
ker   ->    ker
kirke   ->    kirke
kadmeis   ->    kadmeis
kalpurnios   ->    kalpurniɤs
kandake   ->    kandake
kassandra   ->    kassandra
kaiapʰas   ->    kaiapʰas
kɛŋkʰrɛɛ   ->    kɛŋkʰrɛɛ
kepʰisos   ->    kepʰisɤs
kimmɛrios   ->    kimmɛriɤs
klɛanor   ->    klɛanɤr
klɛopʰon   ->    klɛopʰɤn
klɛombrotos   ->    klɛombrɤtɤs
klodios   ->    klɤdiɤs
koptos   ->    koptɤs
kordybe   ->    kɤrdybe
kudetos   ->    kudetɤs
kritobulos   ->    kritobulɤs
krossɛe   ->    krɤssɛe
kydantidɛ   ->    kydantidɛ
kydonia   ->    kydɤnia
kottas   ->    kɤttas
kyr̥r̥os   ->    kyr̥r̥ɤs
kos   ->    kɤs
ladon   ->    ladɤn
lakmon   ->    lakmɤn
larisa   ->    larisa
lɛbɛdos   ->    lɛbɛdɤs
lissos   ->    lissɤs
lampsakenos   ->    lampsakenɤs
lasɛa   ->    lasɛa
lɛksipʰanes   ->    lɛksipʰanes
lɛtriny   ->    lɛtriny
leʍkanos   ->    leʍkanɤs
leʍkotʰɛa   ->    leʍkɤtʰɛa
lɛonides   ->    lɛɤnides
libyrnos   ->    libyrnɤs
likinnia   ->    likinnia
limenarɡoos   ->    limenarɡoɤs
lusios   ->    lusiɤs
lykie   ->    lykie
lykabettos   ->    lykabettɤs
lystra   ->    lystra
maɡdolos   ->    maɡdɤlɤs
madytos   ->    madytɤs
mallios   ->    malliɤs
maria   ->    maria
marion   ->    mariɤn
mɛletos   ->    mɛletɤs
mɛmnon   ->    mɛmnɤn
maɡnesia   ->    maɡnesia
makaria   ->    makaria
malao   ->    malao
manasses   ->    manasses
mantineʍs   ->    mantineʍs
marakanda   ->    marakanda
marmarion   ->    marmariɤn
massalia   ->    massalia
makʰanidas   ->    makʰanidas
mɛɡalehɛllas   ->    mɛɡalehɛllas
mɛlite   ->    mɛlite
mɛrope   ->    mɛrope
mɛssene   ->    mɛssene
mɛtapontios   ->    mɛtapɤntiɤs
melieʍs   ->    melieʍs
minturne   ->    minturne
mnewis   ->    mnewis
morpʰeʍs   ->    mɤrpʰeʍs
munykʰion   ->    munykʰiɤn
mysia   ->    mysia
myra   ->    myra
naɡidos   ->    naɡidɤs
naparis   ->    naparis
narnia   ->    narnia
nɛarkʰos   ->    nɛarkʰɤs
nɛmɛsis   ->    nɛmɛsis
nɛpos   ->    nɛpɤs
nikarkʰos   ->    nikarkʰɤs
naʍkratis   ->    naʍkratis
neleʍs   ->    neleʍs
nikolaos   ->    nikɤlaɤs
nomantinos   ->    nomantinɤs
numɛrios   ->    numɛriɤs
nisos   ->    nisɤs
ksois   ->    ksois
ydipus   ->    ydipus
yklides   ->    yklides
yniadɛ   ->    yniadɛ
yaɡros   ->    yaɡrɤs
uindiks   ->    uindiks
uaros   ->    uarɤs
pakoros   ->    pakɤrɤs
panemos   ->    panemɤs
panormos   ->    panɤrmɤs
parmys   ->    parmys
pɛlla   ->    pɛlla
pɛrɡe   ->    pɛrke
pelekɛs   ->    pelekɛs
piɛrɛs   ->    piɛrɛs
padɛy   ->    padɛy
palɛstine   ->    palɛstine
palis   ->    palis
pallene   ->    pallene
panatʰenaikos   ->    panatʰenaikɤs
paraskewe   ->    paraskewe
partʰia   ->    partʰia
pasikles   ->    pasikles
papʰlaɡonia   ->    papʰlaɡɤnia
pakʰon   ->    pakʰɤn
piritʰus   ->    piritʰus
piraeʍs   ->    piraeʍs
pɛlazɡikos   ->    pɛlazɡikɤs
pɛloponnesios   ->    pɛlopɤnnesiɤs
pɛriklymɛnos   ->    pɛriklymɛnɤs
pɛrtinaks   ->    pɛrtinaks
pikenos   ->    pikenɤs
pitane   ->    pitane
pnewmatohaɡion   ->    pnewmatohaɡiɤn
polykso   ->    pɤlykso
polydoros   ->    pɤlydɤrɤs
porpʰyrion   ->    pɤrpʰyriɤn
potidɛa   ->    pɤtidɛa
preksaspes   ->    preksaspes
prokonnesos   ->    prokɤnnesɤs
prytos   ->    prytɤs
pytʰaɡorikos   ->    pytʰaɡɤrikɤs
pontos   ->    pɤntɤs
pylos   ->    pylɤs
sardis   ->    sardis
ser   ->    ser
sɛpros   ->    sɛprɤs
salɡaneʍs   ->    salɡaneʍs
salonios   ->    salɤniɤs
samosata   ->    samɤsata
saraŋɡɛ   ->    saraŋɡɛ
satan   ->    satan
sɛleʍkides   ->    sɛleʍkides
sɛlinus   ->    sɛlinus
sekuanos   ->    sekuanɤs
stʰɛno   ->    stʰɛno
sintos   ->    sintɤs
sirakeny   ->    sirakeny
skidros   ->    skidrɤs
skylake   ->    skylake
zmila   ->    zmila
zmyrna   ->    zmyrna
solus   ->    sɤlus
suda   ->    suda
strombikʰides   ->    strombikʰides
styllaŋɡion   ->    styllaŋɡiɤn
styks   ->    styks
syrakusɛ   ->    syrakusɛ
sosiɡɛnes   ->    sɤsiɡɛnes
sozusa   ->    sɤzusa
sestos   ->    sestɤs
sinɛ   ->    sinɛ
syros   ->    syrɤs
tanaɡra   ->    tanaɡra
tartaros   ->    tartarɤs
tɛmpe   ->    tɛmpe
telɛpʰos   ->    telɛpʰɤs
tiron   ->    tirɤn
taltʰybios   ->    taltʰybiɤs
tarkynios   ->    tarkyniɤs
tɛlamon   ->    tɛlamɤn
tɛlmessos   ->    tɛlmessɤs
tɛrpsikʰora   ->    tɛrpsikʰɤra
terie   ->    terie
titʰronion   ->    titʰrɤniɤn
timotʰɛos   ->    timɤtʰɛɤs
titanis   ->    titanis
tusklanos   ->    tusklanɤs
trapɛzus   ->    trapɛzus
traianos   ->    traianɤs
troɡilos   ->    troɡilɤs
troos   ->    troɤs
tyndarɛos   ->    tyndarɛɤs
tyrambɛ   ->    tyrambɛ
pʰarbɛtʰos   ->    pʰarbɛtʰɤs
pʰabrikios   ->    pʰabrikiɤs
pʰɛdria   ->    pʰɛdria
pʰɛstos   ->    pʰɛstɤs
pʰarnabazos   ->    pʰarnabazɤs
pʰɛrɛ   ->    pʰɛrɛ
pʰilaidɛ   ->    pʰilaidɛ
pʰlɛɡyas   ->    pʰlɛɡyas
pʰlius   ->    pʰlius
pʰynike   ->    pʰynike
pʰrɛɡɛlla   ->    pʰrɛɡɛlla
pʰryɡia   ->    pʰryɡia
pʰyle   ->    pʰyle
pʰytia   ->    pʰytia
pʰorkos   ->    pʰɤrkɤs
pʰeliks   ->    pʰeliks
kʰaon   ->    kʰaɤn
kʰabrias   ->    kʰabrias
kʰɛronia   ->    kʰɛrɤnia
kʰalastra   ->    kʰalastra
kʰanaan   ->    kʰanaan
kʰaridemos   ->    kʰaridemɤs
kʰrysis   ->    kʰrysis
kʰromios   ->    kʰromiɤs
kʰorsos   ->    kʰɤrsɤs
psessiy   ->    psessiy
psammetikʰos   ->    psammetikʰɤs
psyrie   ->    psyrie
ɛɡialopʰylaks   ->    ɛɡialopʰylaks
ɛdɛomɛ   ->    ɛdɛomɛ
ɛdo   ->    ɛdo
ɛskʰyno   ->    ɛskʰyno
ɛtizo   ->    ɛtizo
hɛrɛsiotes   ->    hɛrɛsiɤtes
ɛtʰ   ->    ɛtʰ
ɛtʰusa   ->    ɛtʰusa
ɛluros   ->    ɛlurɤs
ɛnymɛ   ->    ɛnymɛ
ɛstʰesis   ->    ɛstʰesis
ɛpsa   ->    ɛpsa
aʍtoɛpitʰymia   ->    aʍtoɛpitʰymia
aʍtokʰtʰon   ->    aʍtokʰtʰɤn
aʍtʰ   ->    aʍtʰ
aʍt   ->    aʍt
badios   ->    badiɤs
ballo   ->    ballo
barbaks   ->    barbaks
bɛbelos   ->    bɛbelɤs
beks   ->    beks
bɛno   ->    bɛno
batʰykolpos   ->    batʰykɤlpɤs
balanion   ->    balaniɤn
baptizmos   ->    baptizmɤs
barys   ->    barys
basilewo   ->    basilewo
bassara   ->    bassara
batiake   ->    batiake
βattoloɣia   ->    βattɤloʑia
bdɛllion   ->    bdɛlliɤn
bɛlone   ->    bɛlɤne
bibliotʰeke   ->    bibliɤtʰeke
bizakion   ->    bizakiɤn
bios   ->    biɤs
blɛpo   ->    blɛpo
blabɛros   ->    blabɛrɤs
blastos   ->    blastɤs
blisteris   ->    blisteris
blomos   ->    blomɤs
boetʰia   ->    boetʰia
borboryɡmos   ->    bɤrbɤryɡmɤs
bukoryza   ->    bukɤryza
bustropʰedon   ->    bustropʰedɤn
bulomɛ   ->    bulomɛ
buprestis   ->    buprestis
butyron   ->    butyrɤn
braŋkʰos   ->    braŋkʰɤs
brime   ->    brime
brotolyɡos   ->    brɤtɤlyɡɤs
brykʰema   ->    brykʰema
byblion   ->    bybliɤn
bytʰos   ->    bytʰɤs
bolites   ->    bɤlites
baris   ->    baris
be   ->    be
ɡalas   ->    ɡalas
ɡalos   ->    ɡalɤs
ɡiŋɡros   ->    ɡiŋɡrɤs
ɡɛon   ->    ɡɛɤn
ɡalenos   ->    ɡalenɤs
ɡampsonyks   ->    ɡampsɤnyks
ɡaster   ->    ɡaster
ɡaʍsos   ->    ɡaʍsɤs
ɡiton   ->    ɡitɤn
ɡɛlyos   ->    ɡɛlyɤs
ɡɛnɛtor   ->    ɡɛnɛtɤr
ɡɛnɛtʰliakos   ->    ɡɛnɛtʰliakɤs
ɡɛranion   ->    ɡɛraniɤn
ɡɛr̥r̥okʰɛlone   ->    ɡɛr̥r̥okʰɛlɤne
ɡlamos   ->    ɡlamɤs
ɡlaʍkopis   ->    ɡlaʍkopis
ɡlykys   ->    ɡlykys
ɡlossis   ->    ɡlɤssis
ɡlinos   ->    ɡlinɤs
ɡnotɛra   ->    ɡnɤtɛra
ɡnostikos   ->    ɡnɤstikɤs
ɡones   ->    ɡɤnes
ɡrabion   ->    ɡrabiɤn
ɡrao   ->    ɡrao
ɡramme   ->    ɡramme
ɡryks   ->    ɡryks
ɡylios   ->    ɡyliɤs
ɡynɛkonitis   ->    ɡynɛkɤnitis
ɡypsinos   ->    ɡypsinɤs
dɛ   ->    dɛ
dɛkatos   ->    dɛkatɤs
dɛlpʰaks   ->    dɛlpʰaks
dɛon   ->    dɛɤn
dɛrkomɛ   ->    dɛrkomɛ
dɛro   ->    dɛro
dɛtrosyne   ->    dɛtrɤsyne
daktyliotʰeke   ->    daktyliɤtʰeke
danistes   ->    danistes
dardɛni   ->    dardɛni
dasia   ->    dasia
datɛomɛ   ->    datɛomɛ
diktikos   ->    diktikɤs
dire   ->    dire
dɛndillo   ->    dɛ̥ndillo
deleter   ->    deleter
demopitʰekos   ->    demopitʰekɤs
diabolos   ->    diabɤlɤs
diazoma   ->    diazoma
dialimma   ->    dialimma
diastasis   ->    diastasis
diakonɛo   ->    diakɤnɛo
dialyo   ->    dialyo
dianyo   ->    dianyo
diar̥r̥ɛo   ->    diar̥r̥ɛo
diapʰanes   ->    diapʰanes
diakʰorizo   ->    diakʰɤrizo
ditʰyrambikos   ->    ditʰyrambikɤs
dikɛosyne   ->    dikɛɤsyne
diktamninos   ->    diktamninɤs
dineis   ->    dineis
diykodomɛo   ->    diykɤdomɛo
dipseros   ->    dipserɤs
doassato   ->    doassato
dokɛo   ->    dokɛo
dolikʰos   ->    dɤlikʰɤs
doksazo   ->    doksazo
dorkas   ->    dɤrkas
dotikos   ->    dɤtikɤs
dupɛo   ->    dupɛo
draɡma   ->    draɡma
drakontios   ->    drakɤntiɤs
drastikos   ->    drastikɤs
dropis   ->    dropis
dryops   ->    dryops
dyokɛdɛka   ->    dyokɛdɛka
dyskɛlados   ->    dyskɛladɤs
dystykʰia   ->    dystykʰia
deɡma   ->    deɡma
doma   ->    doma
idetikos   ->    idetikɤs
ik   ->    ik
irenarkʰes   ->    irenarkʰes
isɛrkʰomɛ   ->    isɛrkʰomɛ
himatanopɛriballos   ->    himatanopɛriballɤs
ikosi   ->    ikɤsi
hios   ->    hiɤs
ewɛ   ->    ewɛ
ewdɛmon   ->    ewdɛmɤn
eʍpɛdeʍsia   ->    eʍpɛdeʍsia
ewrypɛdilos   ->    ewrypɛdilɤs
ewronotos   ->    ewrɤnɤtɤs
eʍpʰronɛon   ->    eʍpʰrɤnɛɤn
eʍporos   ->    eʍpɤrɤs
eʍsɛlmos   ->    eʍsɛlmɤs
ewnis   ->    ewnis
eʍtɛ   ->    eʍtɛ
ziŋɡos   ->    ziŋɡɤs
zewɡnymi   ->    zewɡnymi
zoɡanes   ->    zoɡanes
zyɡinos   ->    zyɡinɤs
zonnymi   ->    zɤnnymi
zoo   ->    zoo
zodion   ->    zɤdiɤn
tʰalpsis   ->    tʰalpsis
tʰɛsis   ->    tʰɛsis
tʰɛtes   ->    tʰɛtes
tʰalassɛɡle   ->    tʰalassɛɡle
tʰalɛros   ->    tʰalɛrɤs
tʰanatepʰoros   ->    tʰanatepʰɤrɤs
tʰɛatrokratia   ->    tʰɛatrokratia
tʰɛoloɡos   ->    tʰɛɤloɡɤs
tʰɛopropɛo   ->    tʰɛopropɛo
tʰɛoros   ->    tʰɛɤrɤs
tʰios   ->    tʰiɤs
tʰeriotes   ->    tʰeriɤtes
tʰolɛros   ->    tʰɤlɛrɤs
tʰridaks   ->    tʰridaks
tʰrawma   ->    tʰrawma
tʰronon   ->    tʰrɤnɤn
tʰyroros   ->    tʰyrɤrɤs
tʰymarnon   ->    tʰymarnɤn
tʰymon   ->    tʰymɤn
tʰyrazɛ   ->    tʰyrazɛ
tʰyo   ->    tʰyo
tʰoreks   ->    tʰɤreks
tʰelys   ->    tʰelys
tʰibis   ->    tʰibis
kammaros   ->    kammarɤs
kampsa   ->    kampsa
kapɛtos   ->    kapɛtɤs
karenon   ->    karenɤn
kartos   ->    kartɤs
karpʰos   ->    karpʰɤs
kata   ->    kata
kɛles   ->    kɛles
kɛmmor   ->    kɛmmɤr
kɛrtʰios   ->    kɛrtʰiɤs
kɛrkʰne   ->    kɛrkʰne
kiŋklos   ->    kiŋklɤs
kisirnis   ->    kisirnis
kɛrios   ->    kɛriɤs
katʰ   ->    katʰ
katʰistemi   ->    katʰistemi
katʰartikos   ->    katʰartikɤs
kakkabe   ->    kakkabe
kakomyros   ->    kakomyrɤs
kakos   ->    kakɤs
kalamotʰeke   ->    kalamɤtʰeke
kalia   ->    kalia
kallitʰriks   ->    kallitʰriks
kallipɛtalon   ->    kallipɛtalɤn
kantʰiɛ   ->    kantʰiɛ
karkinos   ->    karkinɤs
kasia   ->    kasia
kataɡnymi   ->    kataɡnymi
katastɛɡos   ->    katastɛɡɤs
katɛpɛpʰnon   ->    katɛpɛpʰnɤn
katalɛɡo   ->    katalɛɡo
katanaŋke   ->    katanaŋke
katapraktikon   ->    katapraktikɤn
katapʰronetikos   ->    katapʰrɤnetikɤs
katɛtyks   ->    katɛtyks
katekʰetes   ->    katekʰetes
katopistʰɛn   ->    katopistʰɛn
kaʍsia   ->    kaʍsia
kakʰɛktes   ->    kakʰɛktes
kɛdrites   ->    kɛdrites
kɛlɛnos   ->    kɛlɛnɤs
kɛntɛo   ->    kɛntɛo
kɛramis   ->    kɛramis
kɛratɛa   ->    kɛratɛa
keʍtʰo   ->    keʍtʰo
kis   ->    kis
kerylos   ->    kerylɤs
kikymis   ->    kikymis
kinɛo   ->    kinɛo
kinyra   ->    kinyra
kladinos   ->    kladinɤs
kletʰrinos   ->    kletʰrinɤs
klitoris   ->    klitɤris
kletos   ->    kletɤs
klisie   ->    klisie
klydon   ->    klydɤn
knips   ->    knips
knekos   ->    knekɤs
kyloma   ->    kyloma
kokkotʰraʍstes   ->    kokkɤtʰraʍstes
kolɛoptɛros   ->    kɤlɛoptɛrɤs
kolymbas   ->    kɤlymbas
kolobion   ->    kɤlobiɤn
komoon   ->    komoɤn
konie   ->    kɤnie
kopadion   ->    kopadiɤn
koriannon   ->    kɤriannɤn
korone   ->    kɤrɤne
kozmopolitas   ->    kɤzmopɤlitas
kuris   ->    kuris
kyos   ->    kyɤs
krɛmbala   ->    krɛmbala
kreɡyos   ->    kreɡyɤs
kritʰinos   ->    kritʰinɤs
krinon   ->    krinɤn
krɛpnos   ->    krɛpnɤs
kranion   ->    kraniɤn
kratɛronyks   ->    kratɛrɤnyks
kratys   ->    kratys
kresɛra   ->    kresɛra
krokomaɡma   ->    krokomaɡma
krupɛzɛ   ->    krupɛzɛ
krypʰa   ->    krypʰa
ktaomɛ   ->    ktaomɛ
ktisis   ->    ktisis
ktenos   ->    ktenɤs
kyanoptɛros   ->    kyanoptɛrɤs
kybɛrnetikos   ->    kybɛrnetikɤs
kykɛon   ->    kykɛɤn
kyminotʰeke   ->    kyminɤtʰeke
kynidion   ->    kynidiɤn
kynokrambe   ->    kynokrambe
kynokkʰalke   ->    kynokkʰalke
kyprinos   ->    kyprinɤs
kobios   ->    kobiɤs
kokyo   ->    kokyo
koŋɡion   ->    koŋɡiɤn
kolos   ->    kɤlɤs
koros   ->    kɤrɤs
korymbos   ->    kɤrymbɤs
kopsa   ->    kopsa
kyknos   ->    kyknɤs
kyritʰra   ->    kyritʰra
kyma   ->    kyma
kypʰi   ->    kypʰi
koma   ->    koma
labrys   ->    labrys
lambda   ->    lambda
lapatʰos   ->    lapatʰɤs
lainos   ->    lainɤs
lien   ->    lien
linon   ->    linɤn
laŋkia   ->    laŋkia
latʰrɛos   ->    latʰrɛɤs
lalɛo   ->    lalɛo
lakʰanotʰeke   ->    lakʰanɤtʰeke
lawra   ->    lawra
lɛpʰos   ->    lɛpʰɤs
libo   ->    libo
liturɡia   ->    liturɡia
lɛktikos   ->    lɛktikɤs
lɛptoɡɛos   ->    lɛptoɡɛɤs
lewros   ->    lewrɤs
libanotʰeke   ->    libanɤtʰeke
loɡomakʰia   ->    loɡomakʰia
lypos   ->    lypɤs
lordos   ->    lɤrdɤs
lyɡros   ->    lyɡrɤs
lykoskordon   ->    lykɤskɤrdɤn
lypros   ->    lyprɤs
lysimakʰion   ->    lysimakʰiɤn
lorymnon   ->    lɤrymnɤn
lokʰos   ->    lokʰɤs
lobe   ->    lobe
lestia   ->    lestia
lezomɛ   ->    lezomɛ
makir   ->    makir
mastiks   ->    mastiks
mɛɡaron   ->    mɛɡarɤn
mɛdomɛ   ->    mɛdomɛ
mɛtʰodos   ->    mɛtʰɤdɤs
mɛlan   ->    mɛlan
mɛlpo   ->    mɛlpo
mɛno   ->    mɛno
mɛtrios   ->    mɛtriɤs
mestor   ->    mestɤr
midas   ->    midas
miksis   ->    miksis
matʰetewo   ->    matʰetewo
mania   ->    mania
masaomɛ   ->    masaomɛ
matɛotɛkʰnia   ->    matɛɤtɛkʰnia
mapsidios   ->    mapsidiɤs
miliɡma   ->    miliɡma
mɛlanuros   ->    mɛlanurɤs
mɛlimelon   ->    mɛlimelɤn
mɛlaŋkorypʰos   ->    mɛlaŋkɤrypʰɤs
mɛnɛɛno   ->    mɛnɛɛno
mɛnoikes   ->    mɛnoikes
mɛsolabos   ->    mɛsɤlabɤs
mɛtaballo   ->    mɛtaballo
mɛtanastasis   ->    mɛtanastasis
mɛtapʰonɛo   ->    mɛtapʰɤnɛo
mɛtykia   ->    mɛtykia
medamos   ->    medamɤs
melotris   ->    melɤtris
menoides   ->    menoides
mekʰanaomɛ   ->    mekʰanaomɛ
mikroloɡia   ->    mikrɤloɡia
mimɛomɛ   ->    mimɛomɛ
mistyllo   ->    mistyllo
mnesipemon   ->    mnesipemɤn
molɡos   ->    mɤlɡɤs
molybdɛna   ->    mɤlybdɛna
mone   ->    mɤne
monarkʰɛo   ->    mɤnarkʰɛo
myɡalɛe   ->    myɡalɛe
mytʰodes   ->    mytʰɤdes
myketinos   ->    myketinɤs
ewopʰtʰalmos   ->    ewopʰtʰalmɤs
myrobalaninos   ->    myrobalaninɤs
myrsinites   ->    myrsinites
monops   ->    mɤnops
moron   ->    mɤrɤn
moskʰinos   ->    mɤskʰinɤs
mokʰtʰos   ->    mokʰtʰɤs
myllos   ->    myllɤs
mystis   ->    mystis
myops   ->    myops
morios   ->    mɤriɤs
medos   ->    medɤs
nartʰeks   ->    nartʰeks
napʰtʰa   ->    napʰtʰa
nɛomɛ   ->    nɛomɛ
ne   ->    ne
nepios   ->    nepiɤs
ninon   ->    ninɤn
nɛ   ->    nɛ
naʍs   ->    naʍs
nɛkro   ->    nɛkro
nɛkydallos   ->    nɛkydallɤs
newra   ->    newra
nɛpʰɛleɡɛrɛta   ->    nɛpʰɛleɡɛrɛta
nikos   ->    nikɤs
nesiotes   ->    nesiɤtes
noɛo   ->    noɛo
nomotʰɛtikos   ->    nomɤtʰɛtikɤs
noseros   ->    nɤserɤs
nytʰos   ->    nytʰɤs
nympʰoleptos   ->    nympʰɤleptɤs
nystaɡmos   ->    nystaɡmɤs
notinos   ->    nɤtinɤs
noton   ->    nɤtɤn
noi   ->    noi
ksɛnos   ->    ksɛnɤs
ksantʰoleʍkos   ->    ksantʰɤleʍkɤs
ksɛnia   ->    ksɛnia
ksenos   ->    ksenɤs
ksylaloe   ->    ksylaloe
ksymplɛo   ->    ksymplɛo
ksynidos   ->    ksynidɤs
ksynos   ->    ksynɤs
ksylon   ->    ksylɤn
ksyo   ->    ksyo
ykonomos   ->    ykɤnomɤs
ynokʰoe   ->    ynokʰoe
ysyinos   ->    ysyinɤs
ykʰomɛnos   ->    ykʰomɛnɤs
ykesis   ->    ykesis
ymy   ->    ymy
hyos   ->    hyɤs
udɛtɛros   ->    udɛtɛrɤs
ulɛ   ->    ulɛ
urɛo   ->    urɛo
uraniskos   ->    uraniskɤs
utis   ->    utis
hunɛka   ->    hunɛka
us   ->    us
pantosɛ   ->    pantɤsɛ
papraks   ->    papraks
parykos   ->    parykɤs
pɛzis   ->    pɛzis
pɛlɛkys   ->    pɛlɛkys
pɛmpʰiks   ->    pɛmpʰiks
pɛtrinos   ->    pɛtrinɤs
pɛpsis   ->    pɛpsis
peɡnymi   ->    peɡnymi
pere   ->    pere
pimplemi   ->    pimplemi
pininos   ->    pininɤs
pion   ->    piɤn
pɛzo   ->    pɛzo
pɛdion   ->    pɛdiɤn
pɛdaɡoɡia   ->    pɛdaɡoɡia
paliurinos   ->    paliurinɤs
pammɛɡɛtʰes   ->    pammɛɡɛtʰes
pantakʰu   ->    pantakʰu
parakytis   ->    parakytis
parapʰrasis   ->    parapʰrasis
parɛrkʰomɛ   ->    parɛrkʰomɛ
parɛ   ->    parɛ
parabolany   ->    parabɤlany
paradiɡmatikos   ->    paradiɡmatikɤs
paralleloɡrammos   ->    paralleloɡrammɤs
paranomia   ->    paranomia
parias   ->    parias
par̥r̥esia   ->    par̥r̥esia
pastos   ->    pastɤs
patɛomɛ   ->    patɛomɛ
patria   ->    patria
pawla   ->    pawla
pɛloris   ->    pɛlɤris
pɛntakiskʰiliy   ->    pɛntakiskʰiliy
pɛntekoste   ->    pɛntekɤste
pɛr   ->    pɛr
pɛrizoma   ->    pɛrizoma
pɛriballo   ->    pɛriballo
pɛriporpʰyros   ->    pɛripɤrpʰyrɤs
pɛristropʰis   ->    pɛristropʰis
pɛrityŋkʰano   ->    pɛrityŋkʰano
pɛrknos   ->    pɛrknɤs
pɛrsɛa   ->    pɛrsɛa
pɛtinos   ->    pɛtinɤs
pizma   ->    pizma
pedos   ->    pedɤs
pizɡis   ->    pizɡis
platʰanon   ->    platʰanɤn
plasis   ->    plasis
plɛɡma   ->    plɛɡma
plemne   ->    plemne
plezmios   ->    plezmiɤs
platanistinos   ->    platanistinɤs
plɛktane   ->    plɛktane
ploke   ->    ploke
plutos   ->    plutɤs
pleɡma   ->    pleɡma
pnoe   ->    pnoe
podenɛmos   ->    pɤdenɛmɤs
pyetes   ->    pyetes
pyne   ->    pyne
polɛmios   ->    pɤlɛmiɤs
polios   ->    pɤliɤs
pollaki   ->    pɤllaki
polymatʰes   ->    pɤlymatʰes
polystapʰylos   ->    pɤlystapʰylɤs
polyɡalon   ->    pɤlyɡalɤn
polypʰlyzbos   ->    pɤlypʰlyzbɤs
pompos   ->    pompɤs
porewo   ->    pɤrewo
prɛmnon   ->    prɛmnɤn
praɡmatikos   ->    praɡmatikɤs
prapis   ->    prapis
proɛkʰo   ->    proɛkʰo
probɛno   ->    probɛno
proɡrapʰe   ->    proɡrapʰe
proorao   ->    proɤrao
prosɛkʰo   ->    prɤsɛkʰo
prozdokao   ->    prɤzdokao
proskenion   ->    prɤskeniɤn
prospʰonɛo   ->    prɤspʰɤnɛo
proti   ->    prɤti
propʰetizo   ->    propʰetizo
protawles   ->    prɤtawles
prototokos   ->    prɤtɤtokɤs
propoma   ->    propoma
prytanis   ->    prytanis
prinos   ->    prinɤs
ptɛrne   ->    ptɛrne
ptisane   ->    ptisane
ptyŋks   ->    ptyŋks
ptoks   ->    ptoks
pyknos   ->    pyknɤs
pyre   ->    pyre
pyramus   ->    pyramus
pyrsos   ->    pyrsɤs
potʰos   ->    pɤtʰɤs
pornos   ->    pɤrnɤs
posis   ->    pɤsis
potmos   ->    pɤtmɤs
pyanos   ->    pyanɤs
pyksos   ->    pyksɤs
poles   ->    pɤles
poy   ->    poy
saktas   ->    saktas
sannas   ->    sannas
sapitʰos   ->    sapitʰɤs
sarks   ->    sarks
satra   ->    satra
sɛbas   ->    sɛbas
sɛbomɛ   ->    sɛbomɛ
sɛsypʰos   ->    sɛsypʰɤs
sidaros   ->    sidarɤs
sizo   ->    sizo
sikyos   ->    sikyɤs
siluros   ->    silurɤs
sisaron   ->    sisarɤn
saɡapenon   ->    saɡapenɤn
sandalotʰeke   ->    sandalɤtʰeke
sarkokele   ->    sarkokele
satyriskos   ->    satyriskɤs
sawroktonos   ->    sawroktɤnɤs
sison   ->    sisɤn
sɛmnos   ->    sɛmnɤs
sɛrɡy   ->    sɛrɡy
semio   ->    semio
siɡe   ->    sike
siderurɡos   ->    siderurɡɤs
sition   ->    sitiɤn
sitonion   ->    sitɤniɤn
siope   ->    siope
skaros   ->    skarɤs
skalis   ->    skalis
skandalizo   ->    skandalizo
skɛlɛtos   ->    skɛlɛtɤs
skewazo   ->    skewazo
skia   ->    skia
skiois   ->    skiois
skykion   ->    skykiɤn
skopie   ->    skopie
skolytʰron   ->    skɤlytʰrɤn
skotos   ->    skɤtɤs
skyros   ->    skyrɤs
skolos   ->    skɤlɤs
zmao   ->    zmao
solinos   ->    sɤlinɤs
sopʰizmos   ->    sopʰizmɤs
susinos   ->    susinɤs
spartinos   ->    spartinɤs
spindalos   ->    spindalɤs
spatʰepʰoros   ->    spatʰepʰɤrɤs
sparɡanion   ->    sparɡaniɤn
spirɛa   ->    spirɛa
spewdo   ->    spewdo
spodos   ->    spɤdɤs
sporos   ->    spɤrɤs
stɛɡe   ->    stɛke
stilbo   ->    stilbo
stasiarkʰes   ->    stasiarkʰes
stapʰylaɡra   ->    stapʰylaɡra
stɛs   ->    stɛs
stɛlɛa   ->    stɛlɛa
stɛnoo   ->    stɛnoo
stoa   ->    stoa
stykʰioo   ->    stykʰioo
stokʰazomɛ   ->    stokʰazomɛ
stykʰos   ->    stykʰɤs
striks   ->    striks
straŋɡuria   ->    straŋɡuria
strateɡia   ->    strateɡia
stratopɛdon   ->    stratopɛdɤn
stropʰaliŋks   ->    stropʰaliŋks
stroma   ->    stroma
stypʰo   ->    stypʰo
steriŋks   ->    steriŋks
syŋɡrapʰeʍs   ->    syŋɡrapʰeʍs
syŋkope   ->    syŋkope
sykopʰantia   ->    sykopʰantia
syllɛɡo   ->    syllɛɡo
symbɛno   ->    symbɛno
symmakʰɛo   ->    symmakʰɛo
symparataksis   ->    symparataksis
sympotes   ->    sympɤtes
synɛrɛsis   ->    synɛrɛsis
synapʰes   ->    synapʰes
synɛksɛrkʰomɛ   ->    synɛksɛrkʰomɛ
synykizo   ->    synykizo
syntɛlia   ->    syntɛlia
systɛllo   ->    systɛllo
spʰaɡnos   ->    spʰaɡnɤs
spʰalɛros   ->    spʰalɛrɤs
spʰiŋktos   ->    spʰiŋktɤs
spʰyzo   ->    spʰyzo
skʰɛma   ->    skʰɛma
skʰalis   ->    skʰalis
skʰinos   ->    skʰinɤs
sybas   ->    sybas
sympʰysis   ->    sympʰysis
syntʰɛsis   ->    syntʰɛsis
syinos   ->    syinɤs
soma   ->    soma
sotron   ->    sɤtrɤn
taksis   ->    taksis
takʰ   ->    takʰ
tɛ   ->    tɛ
tɛramnon   ->    tɛramnɤn
tɛtriks   ->    tɛtriks
tetʰyon   ->    tetʰyɤn
tiprassis   ->    tiprassis
taɡen   ->    taken
tarasso   ->    tarasso
tawros   ->    tawrɤs
tino   ->    tino
tikʰopʰylaks   ->    tikʰopʰylaks
tɛleʍtɛos   ->    tɛleʍtɛɤs
tɛrmintʰinos   ->    tɛrmintʰinɤs
tɛtanos   ->    tɛtanɤs
tɛtrakyklos   ->    tɛtrakyklɤs
teʍtazo   ->    teʍtazo
tɛkʰnoɡrapʰos   ->    tɛkʰnoɡrapʰɤs
temɛlɛo   ->    temɛlɛo
tlemon   ->    tlemɤn
ty   ->    ty
tomos   ->    tomɤs
topikos   ->    topikɤs
trakʰelos   ->    trakʰelɤs
trɛpo   ->    trɛpo
triɛna   ->    triɛna
tribolos   ->    tribɤlɤs
trizmakar   ->    trizmakar
tripʰyllon   ->    tripʰyllɤn
traɡɛlapʰos   ->    traɡɛlapʰɤs
triklinion   ->    trikliniɤn
triodus   ->    triɤdus
tropʰikos   ->    tropʰikɤs
trokʰos   ->    trokʰɤs
tromos   ->    tromɤs
trysis   ->    trysis
tykane   ->    tykane
tolma   ->    tɤlma
tornos   ->    tɤrnɤs
tossos   ->    tɤssɤs
tyrinos   ->    tyrinɤs
tyr̥r̥is   ->    tyr̥r̥is
toto   ->    tɤto
tilos   ->    tilɤs
typʰos   ->    typʰɤs
to   ->    to
hyonos   ->    hyɤnɤs
pʰallɛna   ->    pʰallɛna
pʰarsos   ->    pʰarsɤs
pʰɛrnion   ->    pʰɛrniɤn
pʰanos   ->    pʰanɤs
pʰarkis   ->    pʰarkis
pʰawlos   ->    pʰawlɤs
pʰi   ->    pʰi
pʰtʰina   ->    pʰtʰina
pʰtʰartos   ->    pʰtʰartɤs
pʰtʰonos   ->    pʰtʰɤnɤs
pʰilerɛtmos   ->    pʰilerɛtmɤs
pʰilodoksia   ->    pʰilɤdoksia
pʰiloksɛnos   ->    pʰiloksɛnɤs
pʰilotes   ->    pʰilɤtes
pʰlyktɛna   ->    pʰlyktɛna
pʰytao   ->    pʰytao
pʰoksinos   ->    pʰoksinɤs
pʰu   ->    pʰu
pʰrades   ->    pʰrades
pʰronesis   ->    pʰrɤnesis
pʰye   ->    pʰye
pʰyseter   ->    pʰyseter
pʰone   ->    pʰɤne
pʰos   ->    pʰɤs
kʰaliks   ->    kʰaliks
kʰaraɡma   ->    kʰaraɡma
kʰɛo   ->    kʰɛo
kʰera   ->    kʰera
kʰalkeres   ->    kʰalkeres
kʰalkos   ->    kʰalkɤs
kʰamɛ   ->    kʰamɛ
kʰamɛleʍke   ->    kʰamɛleʍke
kʰamɛplatanos   ->    kʰamɛplatanɤs
kʰartotʰeke   ->    kʰartɤtʰeke
kʰimastron   ->    kʰimastrɤn
kʰironiptron   ->    kʰirɤniptrɤn
kʰɛlidon   ->    kʰɛlidɤn
kʰɛrmas   ->    kʰɛrmas
kʰimɛropʰylaks   ->    kʰimɛropʰylaks
kʰlamys   ->    kʰlamys
kʰloros   ->    kʰlɤrɤs
kʰole   ->    kʰɤle
kʰorawles   ->    kʰɤrawles
kʰoikos   ->    kʰoikɤs
kʰraomɛ   ->    kʰraomɛ
kʰrɛos   ->    kʰrɛɤs
kʰrestotes   ->    kʰrestɤtes
kʰrysolakʰanon   ->    kʰrysɤlakʰanɤn
kʰrysopʰylaks   ->    kʰrysopʰylaks
kʰylos   ->    kʰylɤs
kʰytropus   ->    kʰytropus
kʰoroɡrapʰos   ->    kʰɤroɡrapʰɤs
psalma   ->    psalma
psɛdra   ->    psɛdra
psawrios   ->    psawriɤs
psɛllos   ->    psɛllɤs
psewdoɡrapʰos   ->    psewdoɡrapʰɤs
psewdonymos   ->    psewdɤnymɤs
psykʰros   ->    psykʰrɤs
psolos   ->    psɤlɤs
aw   ->    aw
abyrtake   ->    abyrtake
aɡape   ->    aɡape
aɡatʰos   ->    aɡatʰɤs
aŋɡotʰeke   ->    aŋɡɤtʰeke
aɡɛnɛaloɡetos   ->    aɡɛnɛaloketɤs
aŋkon   ->    aŋkɤn
aɡnos   ->    aɡnɤs
aɡore   ->    aɡɤre
aɡriokinara   ->    aɡriokinara
aŋkʰistia   ->    aŋkʰistia
aɡonia   ->    aɡɤnia
adarke   ->    adarke
adɛspotos   ->    adɛspɤtɤs
adiabaos   ->    adiabaɤs
aɛrɡos   ->    aɛrɡɤs
akalepʰe   ->    akalepʰe
akataskewastos   ->    akataskewastɤs
akidnos   ->    akidnɤs
akraes   ->    akraes
akrobates   ->    akrobates
alabes   ->    alabes
alaomɛ   ->    alaomɛ
alɛksipʰarmakon   ->    alɛksipʰarmakɤn
aletʰie   ->    aleɬʰie
allelon   ->    allelɤn
alpʰadion   ->    alpʰadiɤn
alopeks   ->    alopeks
amandalos   ->    amandalɤs
amɛrɡo   ->    amɛrɡo
amblys   ->    amblys
amybe   ->    amybe
ampɛloprason   ->    ampɛloprasɤn
ampʰiballo   ->    ampʰiballo
ampʰipɛnomɛ   ->    ampʰipɛnomɛ
amorɡinos   ->    amɤrɡinɤs
amyɡdalon   ->    amyɡdalɤn
amyno   ->    amyno
anabrosis   ->    anabrɤsis
anaɡo   ->    anaɡo
anataksis   ->    anataksis
aniketos   ->    aniketɤs
anaisso   ->    anaisso
analɡesia   ->    analkesia
anamimnesko   ->    anamimnesko
anaskewazo   ->    anaskewazo
andrios   ->    andriɤs
antʰɛo   ->    antʰɛo
antʰropoloɡos   ->    antʰropɤloɡɤs
antʰolops   ->    antʰɤlops
anoruo   ->    anɤruo
antibios   ->    antibiɤs
antitʰɛton   ->    antitʰɛtɤn
antir̥r̥inon   ->    antir̥r̥inɤn
aksioprɛpes   ->    aksioprɛpes
aorter   ->    aɤrter
apaneʍtʰɛn   ->    apaneʍtʰɛn
apiria   ->    apiria
apɛrisios   ->    apɛrisiɤs
apobasileʍs   ->    apobasileʍs
apykia   ->    apykia
apokopto   ->    apokopto
apoplɛo   ->    apoplɛo
aporɛo   ->    apɤrɛo
apostole   ->    apɤstɤle
apokʰorɛo   ->    apokʰɤrɛo
apodrasis   ->    apɤdrasis
apollymi   ->    apɤllymi
apomaktron   ->    apomaktrɤn
apon   ->    apɤn
arasso   ->    arasso
arbale   ->    arbale
arɡyrus   ->    arɡyrus
arɡyrion   ->    arɡyriɤn
arɡas   ->    arɡas
areipʰilos   ->    areipʰilɤs
aritʰmɛo   ->    aritʰmɛo
aristeʍs   ->    aristeʍs
arkɛo   ->    arkɛo
aryballis   ->    aryballis
arkʰaŋɡɛlos   ->    arkʰaŋɡɛlɤs
arkʰirabdukʰos   ->    arkʰirabdukʰɤs
aroo   ->    aroo
astʰɛnɛo   ->    astʰɛnɛo
askantes   ->    askantes
aspis   ->    aspis
astrape   ->    astrape
astyɡiton   ->    astyɡitɤn
aspʰalos   ->    aspʰalɤs
asyndɛtos   ->    asyndɛtɤs
asodes   ->    asɤdes
atallo   ->    atallo
atastʰalos   ->    atastʰalɤs
atrapʰaksys   ->    atrapʰaksys
apʰɛrɛo   ->    apʰɛrɛo
apʰorizo   ->    apʰɤrizo
apʰrosyne   ->    apʰrɤsyne
akʰates   ->    akʰates
akʰlys   ->    akʰlys
akʰrios   ->    akʰriɤs
apsintʰion   ->    apsintʰiɤn
habrodiɛtos   ->    habrɤdiɛtɤs
haɡnizmos   ->    haɡnizmɤs
hadinos   ->    hadinɤs
haliporpʰyros   ->    halipɤrpʰyrɤs
halmyros   ->    halmyrɤs
hamartani   ->    hamartani
aaptos   ->    aaptɤs
abatos   ->    abatɤs
aɡamɛ   ->    aɡamɛ
aɡrapʰos   ->    aɡrapʰɤs
aɛtʰlon   ->    aɛtʰlɤn
akantʰos   ->    akantʰɤs
akolos   ->    akɤlɤs
akoros   ->    akɤrɤs
akritʰos   ->    akritʰɤs
alastos   ->    alastɤs
alɡema   ->    alkema
alipʰar   ->    alipʰar
allos   ->    allɤs
ambon   ->    ambɤn
an   ->    an
anartʰros   ->    anartʰrɤs
anɛo   ->    anɛo
anodos   ->    anɤdɤs
anotʰɛn   ->    anɤtʰɛn
akson   ->    aksɤn
aplestos   ->    aplestɤs
arabos   ->    arabɤs
arios   ->    ariɤs
armɛnon   ->    armɛnɤn
ar̥r̥ostos   ->    ar̥r̥ɤstɤs
arsen   ->    arsen
artos   ->    artɤs
askios   ->    askiɤs
askopos   ->    askopɤs
ate   ->    ate
apʰtʰitos   ->    apʰtʰitɤs
hamilla   ->    hamilla
harma   ->    harma
atʰlon   ->    atʰlɤn
abia   ->    abia
aɡesilaos   ->    akesilaɤs
aɡrippine   ->    aɡrippine
adusios   ->    adusiɤs
adryas   ->    adryas
aenobarbos   ->    aenobarbɤs
atʰenesin   ->    atʰenesin
atʰena   ->    atʰena
aktɛon   ->    aktɛɤn
akylios   ->    akyliɤs
alkamɛnes   ->    alkamɛnes
alkmene   ->    alkmene
alyattes   ->    alyattes
amazon   ->    amazɤn
ampʰitʰoe   ->    ampʰitʰoe
anapʰe   ->    anapʰe
anaksimɛnes   ->    anaksimɛnes
andania   ->    andania
antinoos   ->    antinoɤs
antipas   ->    antipas
antikytʰera   ->    antikytʰera
antron   ->    antrɤn
apaturia   ->    apaturia
apidanos   ->    apidanɤs
apuleios   ->    apuleiɤs
arizbe   ->    arizbe
aramɛy   ->    aramɛy
arɡimpasa   ->    arɡimpasa
ariabiɡnes   ->    ariabiɡnes
aristomakʰos   ->    aristomakʰɤs
aristonymos   ->    aristɤnymɤs
artɛmision   ->    artɛmisiɤn
arkʰɛlaos   ->    arkʰɛlaɤs
arkʰidamos   ->    arkʰidamɤs
asɛa   ->    asɛa
assyria   ->    assyria
astɛrion   ->    astɛriɤn
atlantis   ->    atlantis
attikos   ->    attikɤs
akʰaia   ->    akʰaia
hatʰyr   ->    hatʰyr
halikyɛ   ->    halikyɛ
aɡbalos   ->    aɡbalɤs
alos   ->    alɤs
amasis   ->    amasis
ammon   ->    ammɤn
andros   ->    andrɤs
antipʰos   ->    antipʰɤs
arne   ->    arne
arpy   ->    arpy
asios   ->    asiɤs
atropos   ->    atropɤs
ɛŋɡytʰeke   ->    ɛŋɡytʰeke
ɛŋkratia   ->    ɛŋkratia
ɛikostos   ->    ɛikɤstɤs
ɛki   ->    ɛki
ɛkporewo   ->    ɛkpɤrewo
ɛlatinos   ->    ɛlatinɤs
ɛleʍtʰɛropsykʰos   ->    ɛleʍtʰɛropsykʰɤs
ɛlɛos   ->    ɛlɛɤs
ɛllos   ->    ɛllɤs
ɛmmɛno   ->    ɛmmɛno
ɛmpyɛo   ->    ɛmpyɛo
ɛmpyrizmos   ->    ɛmpyrizmɤs
ɛnantion   ->    ɛnantiɤn
ɛndɛlɛkʰes   ->    ɛ̥ndɛlɛkʰes
ɛndyno   ->    ɛ̥ndyno
ɛntʰadɛ   ->    ɛntʰadɛ
ɛntʰronios   ->    ɛntʰrɤniɤs
ɛntɛllo   ->    ɛntɛllo
ɛntos   ->    ɛntɤs
ɛnypnios   ->    ɛnypniɤs
ɛksapto   ->    ɛksapto
ɛksɛnarizo   ->    ɛksɛnarizo
ɛksomoloɡetikos   ->    ɛksomɤloketikɤs
ɛpaɡo   ->    ɛpaɡo
ɛpimakʰos   ->    ɛpimakʰɤs
ɛpɛntitʰemi   ->    ɛpɛntitʰemi
ɛpibɛno   ->    ɛpibɛno
ɛpiɡlossis   ->    ɛpiɡlɤssis
ɛpiikes   ->    ɛpiikes
ɛpikalɛo   ->    ɛpikalɛo
ɛpikratɛo   ->    ɛpikratɛo
ɛpimiks   ->    ɛpimiks
ɛpir̥r̥ɛpo   ->    ɛpir̥r̥ɛpo
ɛpistɛllo   ->    ɛpistɛllo
ɛpitedewma   ->    ɛpitedewma
ɛpipʰora   ->    ɛpipʰɤra
ɛpokʰe   ->    ɛpokʰe
ɛponymon   ->    ɛpɤnymɤn
ɛrɛtes   ->    ɛrɛtes
ɛrɡaster   ->    ɛrɡaster
ɛrɛino   ->    ɛrɛino
ɛrikydes   ->    ɛrikydes
ɛryko   ->    ɛryko
ɛromɛnos   ->    ɛromɛnɤs
ɛremos   ->    ɛremɤs
ɛstʰio   ->    ɛstʰio
ɛskʰarion   ->    ɛskʰariɤn
ɛtosios   ->    ɛtɤsiɤs
ɛpʰallomɛ   ->    ɛpʰallomɛ
ɛpʰewrisko   ->    ɛpʰewrisko
ɛkʰinopus   ->    ɛkʰinopus
ɛyɛrɡes   ->    ɛyɛrkes
hɛbdomekontakɛɛkatontaplasion   ->    hɛ̥bdomekɤntakɛɛkatɤntaplasiɤn
hɛkkɛdɛkatos   ->    hɛkkɛdɛkatɤs
hɛlɛdone   ->    hɛlɛdɤne
hɛksekontamyros   ->    hɛksekɤntamyrɤs
hɛtɛra   ->    hɛtɛra
hɛtɛralkes   ->    hɛtɛralkes
hɛtɛronymos   ->    hɛtɛrɤnymɤs
hɛtymos   ->    hɛtymɤs
ɛpsilon   ->    ɛpsilɤn
ɛbros   ->    ɛbrɤs
ɛŋkawma   ->    ɛŋkawma
ɛŋkʰɛlys   ->    ɛŋkʰɛlys
ɛtʰo   ->    ɛtʰo
ɛɡɡonos   ->    ɛɡɡɤnɤs
ɛkpaɡlos   ->    ɛkpaɡlɤs
ɛktasis   ->    ɛktasis
ɛlɛon   ->    ɛlɛɤn
ɛlymos   ->    ɛlymɤs
ɛmbryon   ->    ɛmbryɤn
ɛmpiros   ->    ɛmpirɤs
ɛnstasis   ->    ɛnstasis
ɛpitʰ   ->    ɛpitʰ
ɛpɛpʰnon   ->    ɛpɛpʰnɤn
ɛripʰos   ->    ɛripʰɤs
ɛros   ->    ɛrɤs
ɛrysos   ->    ɛrysɤs
hɛktos   ->    hɛktɤs
hɛo   ->    hɛo
hɛpomɛ   ->    hɛpomɛ
hɛspɛros   ->    hɛspɛrɤs
ɛlɛpʰenor   ->    ɛlɛpʰenɤr
ɛlpis   ->    ɛlpis
ɛksɛnɛtos   ->    ɛksɛnɛtɤs
ɛpidamnos   ->    ɛpidamnɤs
ɛratoklides   ->    ɛratoklides
ɛrytʰratʰalassa   ->    ɛrytʰratʰalassa
ɛpʰialtes   ->    ɛpʰialtes
ɛpʰrɛm   ->    ɛpʰrɛm
ɛkʰɛmbrotos   ->    ɛkʰɛmbrɤtɤs
hɛkabe   ->    hɛkabe
hɛkate   ->    hɛkate
elβiðios   ->    elβiðiɤs
hɛlkɛtʰion   ->    hɛlkɛtʰiɤn
hɛrmoɡɛnes   ->    hɛrmoɡɛnes
ɛdɛssa   ->    ɛdɛssa
ɛnna   ->    ɛnna
hɛlle   ->    hɛlle
eys   ->    eys
eɡatʰɛos   ->    eɡatʰɛɤs
etʰɛo   ->    etʰɛo
elyɡɛos   ->    elyɡɛɤs
epiolos   ->    epiɤlɤs
heliazomɛ   ->    heliazomɛ
heliomantia   ->    heliomantia
hemɛra   ->    hemɛra
hemikrania   ->    hemikrania
hemitalanton   ->    hemitalantɤn
hesykʰastes   ->    hesykʰastes
etʰo   ->    etʰo
enystron   ->    enystrɤn
heros   ->    herɤs
hedos   ->    hedɤs
edonos   ->    edɤnɤs
ekʰo   ->    ekʰo
heɡesipyle   ->    hekesipyle
heraklɛotes   ->    heraklɛɤtes
herostratos   ->    herɤstratɤs
iakʰo   ->    iakʰo
idɛa   ->    idɛa
idioma   ->    idioma
ioides   ->    ioides
iskʰion   ->    iskʰiɤn
isopsepʰos   ->    isopsepʰɤs
ikʰtʰyao   ->    ikʰtʰyao
hiɛraks   ->    hiɛraks
hidroo   ->    hidroo
hiɛromyrtos   ->    hiɛromyrtɤs
hikɛtia   ->    hikɛtia
himation   ->    himatiɤn
hippoprosopos   ->    hippoprɤsopɤs
hippodromos   ->    hippɤdromɤs
hippokremnos   ->    hippokremnɤs
hippopʰlomos   ->    hippopʰlomɤs
hiros   ->    hirɤs
historikos   ->    histɤrikɤs
iasis   ->    iasis
iɡdis   ->    iɡdis
ikria   ->    ikria
ilarkʰos   ->    ilarkʰɤs
induros   ->    indurɤs
ikʰnos   ->    ikʰnɤs
hiemi   ->    hiemi
hin   ->    hin
iliŋks   ->    iliŋks
ipos   ->    ipɤs
ialmɛnos   ->    ialmɛnɤs
iabɛzɛbytʰ   ->    iabɛzɛbytʰ
iaksamatɛ   ->    iaksamatɛ
itʰometes   ->    itʰometes
illyrios   ->    illyriɤs
inopopʰylaks   ->    inopopʰylaks
iudaikos   ->    iudaikɤs
iunios   ->    iuniɤs
izmael   ->    izmael
isondɛ   ->    isɤndɛ
italos   ->    italɤs
ipʰiɡɛnia   ->    ipʰiɡɛnia
ionopolis   ->    iɤnopɤlis
ioppi   ->    ioppi
hiɛrikʰo   ->    hiɛrikʰo
hiɛropʰon   ->    hiɛropʰɤn
izburos   ->    izburɤs
itylos   ->    itylɤs
obɛliskos   ->    obɛliskɤs
okris   ->    okris
oliɡarkʰikos   ->    ɤliɡarkʰikɤs
oliɡopsykʰɛo   ->    ɤliɡopsykʰɛo
olopʰydnos   ->    ɤlopʰydnɤs
oniskos   ->    ɤniskɤs
onidizo   ->    ɤnidizo
onomastikon   ->    ɤnomastikɤn
oksya   ->    oksya
oksyinos   ->    oksyinɤs
opallios   ->    opalliɤs
optos   ->    optɤs
orɡizo   ->    ɤrɡizo
ortʰodoksia   ->    ɤrtʰɤdoksia
oropʰe   ->    ɤropʰe
orymaɡdos   ->    ɤrymaɡdɤs
orkʰɛomɛ   ->    ɤrkʰɛomɛ
ostun   ->    ɤstun
okʰtʰɛo   ->    okʰtʰɛo
opsotʰeke   ->    opsɤtʰeke
homyotropos   ->    homyɤtropɤs
horizon   ->    hɤrizɤn
hormatʰos   ->    hɤrmatʰɤs
obryzon   ->    obryzɤn
oɡmos   ->    oɡmɤs
ollymi   ->    ɤllymi
ompʰaks   ->    ompʰaks
onyma   ->    ɤnyma
opistʰɛn   ->    opistʰɛn
orɛksis   ->    ɤrɛksis
opʰɛlon   ->    opʰɛlɤn
hotʰɛn   ->    hɤtʰɛn
homilos   ->    homilɤs
homoros   ->    homɤrɤs
hoplon   ->    hoplɤn
horasis   ->    hɤrasis
hosios   ->    hɤsiɤs
hospɛr   ->    hɤspɛr
hossos   ->    hɤssɤs
hotɛ   ->    hɤtɛ
hotti   ->    hɤtti
odyseʍs   ->    ɤdyseʍs
odomanty   ->    ɤdomanty
oloosson   ->    ɤloɤssɤn
olympios   ->    ɤlympiɤs
ombrike   ->    ombrike
oksyr̥r̥yŋkʰos   ->    oksyr̥r̥yŋkʰɤs
opus   ->    opus
ornɛates   ->    ɤrnɛates
orytes   ->    ɤrytes
opʰrynion   ->    opʰryniɤn
hortesios   ->    hɤrtesiɤs
olbasa   ->    ɤlbasa
hyɡropʰtʰoŋɡos   ->    hyɡropʰtʰoŋɡɤs
hydrokɛpʰalon   ->    hydrokɛpʰalɤn
hydroskopion   ->    hydrɤskopiɤn
hypɛrpʰron   ->    hypɛrpʰrɤn
hypallasso   ->    hypallasso
hypɛrnɛpʰɛlos   ->    hypɛrnɛpʰɛlɤs
hyperɛsia   ->    hyperɛsia
hypoklɛpto   ->    hypoklɛpto
hypomɛno   ->    hypomɛno
hypostates   ->    hypɤstates
hypotɛlɛo   ->    hypɤtɛlɛo
hypobatʰron   ->    hypobatʰrɤn
hypodema   ->    hypɤdema
hystɛrema   ->    hystɛrema
hypʰeɡesis   ->    hypʰekesis
hypsotʰɛn   ->    hypsɤtʰɛn
hyopʰtʰalmos   ->    hyopʰtʰalmɤs
ymmɛs   ->    ymmɛs
hyalos   ->    hyalɤs
hypatos   ->    hypatɤs
hyraks   ->    hyraks
hypsi   ->    hypsi
hys   ->    hys
hymɛs   ->    hymɛs
hypɛrbɛrɛtɛos   ->    hypɛrbɛrɛtɛɤs
hypɛresie   ->    hypɛresie
hyble   ->    hyble
hydissa   ->    hydissa
hyssos   ->    hyssɤs
okimoidɛs   ->    okimoidɛs
omotribes   ->    omɤtribes
opʰɛlɛo   ->    opʰɛlɛo
o   ->    o
ora   ->    ɤra
orion   ->    ɤriɤn
ostia   ->    ɤstia
ode   ->    ɤde
r̥azma   ->    r̥azma
r̥ammatinos   ->    r̥ammatinɤs
r̥apʰidotʰeke   ->    r̥apʰidɤtʰeke
r̥itʰron   ->    r̥itʰrɤn
r̥etorikos   ->    r̥etɤrikɤs
r̥inotoros   ->    r̥inɤtɤrɤs
r̥iskopʰylaks   ->    r̥iskopʰylaks
r̥omboides   ->    r̥omboides
r̥ytʰmos   ->    r̥ytʰmɤs
r̥yparopʰaɡos   ->    r̥yparopʰaɡɤs
r̥ytis   ->    r̥ytis
r̥okʰmos   ->    r̥okʰmɤs
r̥ome   ->    r̥ome
r̥atʰymos   ->    r̥atʰymɤs
r̥abɛnna   ->    r̥abɛnna
r̥ɛa   ->    r̥ɛa
r̥ebas   ->    r̥ebas
r̥enia   ->    r̥enia
r̥izus   ->    r̥izus
r̥uben   ->    r̥uben
r̥ode   ->    r̥ɤde


CHANGED WORDS ; 

tatɤs  ;  ɤs  ;  ɛɡistʰɤs  ;  ɛtʰalɤs  ;  ɛɤlɤs  ;  aʍtɤnoe  ;  aʍksumɤn  ;  betriakɤn  ;  byɤtɤs  ;  bɤttiɛy  ;  budiɤn  ;  brawrɤn  ;  bɤlkɤn  ;  bɤspɤrɤs  ;  ɡɛreniɤs  ;  keryɤnas  ;  ɡɤlɡɤtʰa  ;  ɡɤrɡias  ;  ɡɤrillɛ  ;  damaskɤs  ;  dinɤlokʰɤs  ;  demaratɤs  ;  demopʰilɤs  ;  diɤnysiɤs  ;  diɤskurɤs  ;  domitiɤs  ;  drilɤn  ;  dɤrimakʰɤs  ;  eʍkʰenɤr  ;  ewmɛɤs  ;  zbɛltʰiurdɤs  ;  zenobiɤs  ;  tʰapsakɤs  ;  tʰɛsprɤtɤs  ;  tʰɛopʰrastɤs  ;  kamirɤs  ;  karbɤn  ;  kastabɤs  ;  katɤn  ;  kalpurniɤs  ;  kepʰisɤs  ;  kimmɛriɤs  ;  klɛanɤr  ;  klɛopʰɤn  ;  klɛombrɤtɤs  ;  klɤdiɤs  ;  koptɤs  ;  kɤrdybe  ;  kudetɤs  ;  kritobulɤs  ;  krɤssɛe  ;  kydɤnia  ;  kɤttas  ;  kyr̥r̥ɤs  ;  kɤs  ;  ladɤn  ;  lakmɤn  ;  lɛbɛdɤs  ;  lissɤs  ;  lampsakenɤs  ;  leʍkanɤs  ;  leʍkɤtʰɛa  ;  lɛɤnides  ;  libyrnɤs  ;  limenarɡoɤs  ;  lusiɤs  ;  lykabettɤs  ;  maɡdɤlɤs  ;  madytɤs  ;  malliɤs  ;  mariɤn  ;  mɛletɤs  ;  mɛmnɤn  ;  marmariɤn  ;  mɛtapɤntiɤs  ;  mɤrpʰeʍs  ;  munykʰiɤn  ;  naɡidɤs  ;  nɛarkʰɤs  ;  nɛpɤs  ;  nikarkʰɤs  ;  nikɤlaɤs  ;  nomantinɤs  ;  numɛriɤs  ;  nisɤs  ;  yaɡrɤs  ;  uarɤs  ;  pakɤrɤs  ;  panemɤs  ;  panɤrmɤs  ;  pɛrke  ;  panatʰenaikɤs  ;  papʰlaɡɤnia  ;  pakʰɤn  ;  pɛlazɡikɤs  ;  pɛlopɤnnesiɤs  ;  pɛriklymɛnɤs  ;  pikenɤs  ;  pnewmatohaɡiɤn  ;  pɤlykso  ;  pɤlydɤrɤs  ;  pɤrpʰyriɤn  ;  pɤtidɛa  ;  prokɤnnesɤs  ;  prytɤs  ;  pytʰaɡɤrikɤs  ;  pɤntɤs  ;  pylɤs  ;  sɛprɤs  ;  salɤniɤs  ;  samɤsata  ;  sekuanɤs  ;  sintɤs  ;  skidrɤs  ;  sɤlus  ;  styllaŋɡiɤn  ;  sɤsiɡɛnes  ;  sɤzusa  ;  sestɤs  ;  syrɤs  ;  tartarɤs  ;  telɛpʰɤs  ;  tirɤn  ;  taltʰybiɤs  ;  tarkyniɤs  ;  tɛlamɤn  ;  tɛlmessɤs  ;  tɛrpsikʰɤra  ;  titʰrɤniɤn  ;  timɤtʰɛɤs  ;  tusklanɤs  ;  traianɤs  ;  troɡilɤs  ;  troɤs  ;  tyndarɛɤs  ;  pʰarbɛtʰɤs  ;  pʰabrikiɤs  ;  pʰɛstɤs  ;  pʰarnabazɤs  ;  pʰɤrkɤs  ;  kʰaɤn  ;  kʰɛrɤnia  ;  kʰaridemɤs  ;  kʰromiɤs  ;  kʰɤrsɤs  ;  psammetikʰɤs  ;  hɛrɛsiɤtes  ;  ɛlurɤs  ;  aʍtokʰtʰɤn  ;  badiɤs  ;  bɛbelɤs  ;  batʰykɤlpɤs  ;  balaniɤn  ;  baptizmɤs  ;  βattɤloʑia  ;  bdɛlliɤn  ;  bɛlɤne  ;  bibliɤtʰeke  ;  bizakiɤn  ;  biɤs  ;  blabɛrɤs  ;  blastɤs  ;  blomɤs  ;  bɤrbɤryɡmɤs  ;  bukɤryza  ;  bustropʰedɤn  ;  butyrɤn  ;  braŋkʰɤs  ;  brɤtɤlyɡɤs  ;  bybliɤn  ;  bytʰɤs  ;  bɤlites  ;  ɡalɤs  ;  ɡiŋɡrɤs  ;  ɡɛɤn  ;  ɡalenɤs  ;  ɡampsɤnyks  ;  ɡaʍsɤs  ;  ɡitɤn  ;  ɡɛlyɤs  ;  ɡɛnɛtɤr  ;  ɡɛnɛtʰliakɤs  ;  ɡɛraniɤn  ;  ɡɛr̥r̥okʰɛlɤne  ;  ɡlamɤs  ;  ɡlɤssis  ;  ɡlinɤs  ;  ɡnɤtɛra  ;  ɡnɤstikɤs  ;  ɡɤnes  ;  ɡrabiɤn  ;  ɡyliɤs  ;  ɡynɛkɤnitis  ;  ɡypsinɤs  ;  dɛkatɤs  ;  dɛɤn  ;  dɛtrɤsyne  ;  daktyliɤtʰeke  ;  diktikɤs  ;  dɛ̥ndillo  ;  demopitʰekɤs  ;  diabɤlɤs  ;  diakɤnɛo  ;  diakʰɤrizo  ;  ditʰyrambikɤs  ;  dikɛɤsyne  ;  diktamninɤs  ;  diykɤdomɛo  ;  dipserɤs  ;  dɤlikʰɤs  ;  dɤrkas  ;  dɤtikɤs  ;  drakɤntiɤs  ;  drastikɤs  ;  dyskɛladɤs  ;  idetikɤs  ;  himatanopɛriballɤs  ;  ikɤsi  ;  hiɤs  ;  ewdɛmɤn  ;  ewrypɛdilɤs  ;  ewrɤnɤtɤs  ;  eʍpʰrɤnɛɤn  ;  eʍpɤrɤs  ;  eʍsɛlmɤs  ;  ziŋɡɤs  ;  zyɡinɤs  ;  zɤnnymi  ;  zɤdiɤn  ;  tʰalɛrɤs  ;  tʰanatepʰɤrɤs  ;  tʰɛɤloɡɤs  ;  tʰɛɤrɤs  ;  tʰiɤs  ;  tʰeriɤtes  ;  tʰɤlɛrɤs  ;  tʰrɤnɤn  ;  tʰyrɤrɤs  ;  tʰymarnɤn  ;  tʰymɤn  ;  tʰɤreks  ;  kammarɤs  ;  kapɛtɤs  ;  karenɤn  ;  kartɤs  ;  karpʰɤs  ;  kɛmmɤr  ;  kɛrtʰiɤs  ;  kiŋklɤs  ;  kɛriɤs  ;  katʰartikɤs  ;  kakomyrɤs  ;  kakɤs  ;  kalamɤtʰeke  ;  kallipɛtalɤn  ;  karkinɤs  ;  katastɛɡɤs  ;  katɛpɛpʰnɤn  ;  katapraktikɤn  ;  katapʰrɤnetikɤs  ;  kɛlɛnɤs  ;  kerylɤs  ;  kladinɤs  ;  kletʰrinɤs  ;  klitɤris  ;  kletɤs  ;  klydɤn  ;  knekɤs  ;  kokkɤtʰraʍstes  ;  kɤlɛoptɛrɤs  ;  kɤlymbas  ;  kɤlobiɤn  ;  komoɤn  ;  kɤnie  ;  kopadiɤn  ;  kɤriannɤn  ;  kɤrɤne  ;  kɤzmopɤlitas  ;  kyɤs  ;  kreɡyɤs  ;  kritʰinɤs  ;  krinɤn  ;  krɛpnɤs  ;  kraniɤn  ;  kratɛrɤnyks  ;  ktenɤs  ;  kyanoptɛrɤs  ;  kybɛrnetikɤs  ;  kykɛɤn  ;  kyminɤtʰeke  ;  kynidiɤn  ;  kyprinɤs  ;  kobiɤs  ;  koŋɡiɤn  ;  kɤlɤs  ;  kɤrɤs  ;  kɤrymbɤs  ;  kyknɤs  ;  lapatʰɤs  ;  lainɤs  ;  linɤn  ;  latʰrɛɤs  ;  lakʰanɤtʰeke  ;  lɛpʰɤs  ;  lɛktikɤs  ;  lɛptoɡɛɤs  ;  lewrɤs  ;  libanɤtʰeke  ;  lypɤs  ;  lɤrdɤs  ;  lyɡrɤs  ;  lykɤskɤrdɤn  ;  lyprɤs  ;  lysimakʰiɤn  ;  lɤrymnɤn  ;  lokʰɤs  ;  mɛɡarɤn  ;  mɛtʰɤdɤs  ;  mɛtriɤs  ;  mestɤr  ;  matɛɤtɛkʰnia  ;  mapsidiɤs  ;  mɛlanurɤs  ;  mɛlimelɤn  ;  mɛlaŋkɤrypʰɤs  ;  mɛsɤlabɤs  ;  mɛtapʰɤnɛo  ;  medamɤs  ;  melɤtris  ;  mikrɤloɡia  ;  mnesipemɤn  ;  mɤlɡɤs  ;  mɤlybdɛna  ;  mɤne  ;  mɤnarkʰɛo  ;  mytʰɤdes  ;  myketinɤs  ;  ewopʰtʰalmɤs  ;  myrobalaninɤs  ;  mɤnops  ;  mɤrɤn  ;  mɤskʰinɤs  ;  mokʰtʰɤs  ;  myllɤs  ;  mɤriɤs  ;  medɤs  ;  nepiɤs  ;  ninɤn  ;  nɛkydallɤs  ;  nikɤs  ;  nesiɤtes  ;  nomɤtʰɛtikɤs  ;  nɤserɤs  ;  nytʰɤs  ;  nympʰɤleptɤs  ;  nystaɡmɤs  ;  nɤtinɤs  ;  nɤtɤn  ;  ksɛnɤs  ;  ksantʰɤleʍkɤs  ;  ksenɤs  ;  ksynidɤs  ;  ksynɤs  ;  ksylɤn  ;  ykɤnomɤs  ;  ysyinɤs  ;  ykʰomɛnɤs  ;  hyɤs  ;  udɛtɛrɤs  ;  uraniskɤs  ;  pantɤsɛ  ;  parykɤs  ;  pɛtrinɤs  ;  pininɤs  ;  piɤn  ;  pɛdiɤn  ;  paliurinɤs  ;  parabɤlany  ;  paradiɡmatikɤs  ;  paralleloɡrammɤs  ;  pastɤs  ;  pɛlɤris  ;  pɛntekɤste  ;  pɛripɤrpʰyrɤs  ;  pɛrknɤs  ;  pɛtinɤs  ;  pedɤs  ;  platʰanɤn  ;  plezmiɤs  ;  platanistinɤs  ;  plutɤs  ;  pɤdenɛmɤs  ;  pɤlɛmiɤs  ;  pɤliɤs  ;  pɤllaki  ;  pɤlymatʰes  ;  pɤlystapʰylɤs  ;  pɤlyɡalɤn  ;  pɤlypʰlyzbɤs  ;  pompɤs  ;  pɤrewo  ;  prɛmnɤn  ;  praɡmatikɤs  ;  proɤrao  ;  prɤsɛkʰo  ;  prɤzdokao  ;  prɤskeniɤn  ;  prɤspʰɤnɛo  ;  prɤti  ;  prɤtawles  ;  prɤtɤtokɤs  ;  prinɤs  ;  pyknɤs  ;  pyrsɤs  ;  pɤtʰɤs  ;  pɤrnɤs  ;  pɤsis  ;  pɤtmɤs  ;  pyanɤs  ;  pyksɤs  ;  pɤles  ;  sapitʰɤs  ;  sɛsypʰɤs  ;  sidarɤs  ;  sikyɤs  ;  silurɤs  ;  sisarɤn  ;  saɡapenɤn  ;  sandalɤtʰeke  ;  satyriskɤs  ;  sawroktɤnɤs  ;  sisɤn  ;  sɛmnɤs  ;  sike  ;  siderurɡɤs  ;  sitiɤn  ;  sitɤniɤn  ;  skarɤs  ;  skɛlɛtɤs  ;  skykiɤn  ;  skɤlytʰrɤn  ;  skɤtɤs  ;  skyrɤs  ;  skɤlɤs  ;  sɤlinɤs  ;  sopʰizmɤs  ;  susinɤs  ;  spartinɤs  ;  spindalɤs  ;  spatʰepʰɤrɤs  ;  sparɡaniɤn  ;  spɤdɤs  ;  spɤrɤs  ;  stɛke  ;  stykʰɤs  ;  stratopɛdɤn  ;  sympɤtes  ;  spʰaɡnɤs  ;  spʰalɛrɤs  ;  spʰiŋktɤs  ;  skʰinɤs  ;  syinɤs  ;  sɤtrɤn  ;  tɛramnɤn  ;  tetʰyɤn  ;  taken  ;  tawrɤs  ;  tɛleʍtɛɤs  ;  tɛrmintʰinɤs  ;  tɛtanɤs  ;  tɛtrakyklɤs  ;  tɛkʰnoɡrapʰɤs  ;  tlemɤn  ;  tomɤs  ;  topikɤs  ;  trakʰelɤs  ;  tribɤlɤs  ;  tripʰyllɤn  ;  traɡɛlapʰɤs  ;  trikliniɤn  ;  triɤdus  ;  tropʰikɤs  ;  trokʰɤs  ;  tromɤs  ;  tɤlma  ;  tɤrnɤs  ;  tɤssɤs  ;  tyrinɤs  ;  tɤto  ;  tilɤs  ;  typʰɤs  ;  hyɤnɤs  ;  pʰarsɤs  ;  pʰɛrniɤn  ;  pʰanɤs  ;  pʰawlɤs  ;  pʰtʰartɤs  ;  pʰtʰɤnɤs  ;  pʰilerɛtmɤs  ;  pʰilɤdoksia  ;  pʰiloksɛnɤs  ;  pʰilɤtes  ;  pʰoksinɤs  ;  pʰrɤnesis  ;  pʰɤne  ;  pʰɤs  ;  kʰalkɤs  ;  kʰamɛplatanɤs  ;  kʰartɤtʰeke  ;  kʰimastrɤn  ;  kʰirɤniptrɤn  ;  kʰɛlidɤn  ;  kʰlɤrɤs  ;  kʰɤle  ;  kʰɤrawles  ;  kʰoikɤs  ;  kʰrɛɤs  ;  kʰrestɤtes  ;  kʰrysɤlakʰanɤn  ;  kʰylɤs  ;  kʰɤroɡrapʰɤs  ;  psawriɤs  ;  psɛllɤs  ;  psewdoɡrapʰɤs  ;  psewdɤnymɤs  ;  psykʰrɤs  ;  psɤlɤs  ;  aɡatʰɤs  ;  aŋɡɤtʰeke  ;  aɡɛnɛaloketɤs  ;  aŋkɤn  ;  aɡnɤs  ;  aɡɤre  ;  aɡɤnia  ;  adɛspɤtɤs  ;  adiabaɤs  ;  aɛrɡɤs  ;  akataskewastɤs  ;  akidnɤs  ;  alɛksipʰarmakɤn  ;  aleɬʰie  ;  allelɤn  ;  alpʰadiɤn  ;  amandalɤs  ;  ampɛloprasɤn  ;  amɤrɡinɤs  ;  amyɡdalɤn  ;  anabrɤsis  ;  aniketɤs  ;  analkesia  ;  andriɤs  ;  antʰropɤloɡɤs  ;  antʰɤlops  ;  anɤruo  ;  antibiɤs  ;  antitʰɛtɤn  ;  antir̥r̥inɤn  ;  aɤrter  ;  apɛrisiɤs  ;  apɤrɛo  ;  apɤstɤle  ;  apokʰɤrɛo  ;  apɤdrasis  ;  apɤllymi  ;  apomaktrɤn  ;  apɤn  ;  arɡyriɤn  ;  areipʰilɤs  ;  arkʰaŋɡɛlɤs  ;  arkʰirabdukʰɤs  ;  astyɡitɤn  ;  aspʰalɤs  ;  asyndɛtɤs  ;  asɤdes  ;  atastʰalɤs  ;  apʰɤrizo  ;  apʰrɤsyne  ;  akʰriɤs  ;  apsintʰiɤn  ;  habrɤdiɛtɤs  ;  haɡnizmɤs  ;  hadinɤs  ;  halipɤrpʰyrɤs  ;  halmyrɤs  ;  aaptɤs  ;  abatɤs  ;  aɡrapʰɤs  ;  aɛtʰlɤn  ;  akantʰɤs  ;  akɤlɤs  ;  akɤrɤs  ;  akritʰɤs  ;  alastɤs  ;  alkema  ;  allɤs  ;  ambɤn  ;  anartʰrɤs  ;  anɤdɤs  ;  anɤtʰɛn  ;  aksɤn  ;  aplestɤs  ;  arabɤs  ;  ariɤs  ;  armɛnɤn  ;  ar̥r̥ɤstɤs  ;  artɤs  ;  askiɤs  ;  askopɤs  ;  apʰtʰitɤs  ;  atʰlɤn  ;  akesilaɤs  ;  adusiɤs  ;  aenobarbɤs  ;  aktɛɤn  ;  akyliɤs  ;  amazɤn  ;  antinoɤs  ;  antrɤn  ;  apidanɤs  ;  apuleiɤs  ;  aristomakʰɤs  ;  aristɤnymɤs  ;  artɛmisiɤn  ;  arkʰɛlaɤs  ;  arkʰidamɤs  ;  astɛriɤn  ;  attikɤs  ;  aɡbalɤs  ;  alɤs  ;  ammɤn  ;  andrɤs  ;  antipʰɤs  ;  asiɤs  ;  atropɤs  ;  ɛikɤstɤs  ;  ɛkpɤrewo  ;  ɛlatinɤs  ;  ɛleʍtʰɛropsykʰɤs  ;  ɛlɛɤs  ;  ɛllɤs  ;  ɛmpyrizmɤs  ;  ɛnantiɤn  ;  ɛ̥ndɛlɛkʰes  ;  ɛ̥ndyno  ;  ɛntʰrɤniɤs  ;  ɛntɤs  ;  ɛnypniɤs  ;  ɛksomɤloketikɤs  ;  ɛpimakʰɤs  ;  ɛpiɡlɤssis  ;  ɛpipʰɤra  ;  ɛpɤnymɤn  ;  ɛromɛnɤs  ;  ɛremɤs  ;  ɛskʰariɤn  ;  ɛtɤsiɤs  ;  ɛyɛrkes  ;  hɛ̥bdomekɤntakɛɛkatɤntaplasiɤn  ;  hɛkkɛdɛkatɤs  ;  hɛlɛdɤne  ;  hɛksekɤntamyrɤs  ;  hɛtɛrɤnymɤs  ;  hɛtymɤs  ;  ɛpsilɤn  ;  ɛbrɤs  ;  ɛɡɡɤnɤs  ;  ɛkpaɡlɤs  ;  ɛlɛɤn  ;  ɛlymɤs  ;  ɛmbryɤn  ;  ɛmpirɤs  ;  ɛpɛpʰnɤn  ;  ɛripʰɤs  ;  ɛrɤs  ;  ɛrysɤs  ;  hɛktɤs  ;  hɛspɛrɤs  ;  ɛlɛpʰenɤr  ;  ɛksɛnɛtɤs  ;  ɛpidamnɤs  ;  ɛkʰɛmbrɤtɤs  ;  elβiðiɤs  ;  hɛlkɛtʰiɤn  ;  eɡatʰɛɤs  ;  elyɡɛɤs  ;  epiɤlɤs  ;  hemitalantɤn  ;  enystrɤn  ;  herɤs  ;  hedɤs  ;  edɤnɤs  ;  hekesipyle  ;  heraklɛɤtes  ;  herɤstratɤs  ;  iskʰiɤn  ;  isopsepʰɤs  ;  hiɛromyrtɤs  ;  himatiɤn  ;  hippoprɤsopɤs  ;  hippɤdromɤs  ;  hippokremnɤs  ;  hippopʰlomɤs  ;  hirɤs  ;  histɤrikɤs  ;  ilarkʰɤs  ;  indurɤs  ;  ikʰnɤs  ;  ipɤs  ;  ialmɛnɤs  ;  illyriɤs  ;  iudaikɤs  ;  iuniɤs  ;  isɤndɛ  ;  italɤs  ;  iɤnopɤlis  ;  hiɛropʰɤn  ;  izburɤs  ;  itylɤs  ;  obɛliskɤs  ;  ɤliɡarkʰikɤs  ;  ɤliɡopsykʰɛo  ;  ɤlopʰydnɤs  ;  ɤniskɤs  ;  ɤnidizo  ;  ɤnomastikɤn  ;  oksyinɤs  ;  opalliɤs  ;  optɤs  ;  ɤrɡizo  ;  ɤrtʰɤdoksia  ;  ɤropʰe  ;  ɤrymaɡdɤs  ;  ɤrkʰɛomɛ  ;  ɤstun  ;  opsɤtʰeke  ;  homyɤtropɤs  ;  hɤrizɤn  ;  hɤrmatʰɤs  ;  obryzɤn  ;  oɡmɤs  ;  ɤllymi  ;  ɤnyma  ;  ɤrɛksis  ;  opʰɛlɤn  ;  hɤtʰɛn  ;  homilɤs  ;  homɤrɤs  ;  hoplɤn  ;  hɤrasis  ;  hɤsiɤs  ;  hɤspɛr  ;  hɤssɤs  ;  hɤtɛ  ;  hɤtti  ;  ɤdyseʍs  ;  ɤdomanty  ;  ɤloɤssɤn  ;  ɤlympiɤs  ;  oksyr̥r̥yŋkʰɤs  ;  ɤrnɛates  ;  ɤrytes  ;  opʰryniɤn  ;  hɤrtesiɤs  ;  ɤlbasa  ;  hyɡropʰtʰoŋɡɤs  ;  hydrokɛpʰalɤn  ;  hydrɤskopiɤn  ;  hypɛrpʰrɤn  ;  hypɛrnɛpʰɛlɤs  ;  hypɤstates  ;  hypɤtɛlɛo  ;  hypobatʰrɤn  ;  hypɤdema  ;  hypʰekesis  ;  hypsɤtʰɛn  ;  hyopʰtʰalmɤs  ;  hyalɤs  ;  hypatɤs  ;  hypɛrbɛrɛtɛɤs  ;  hyssɤs  ;  omɤtribes  ;  ɤra  ;  ɤriɤn  ;  ɤstia  ;  ɤde  ;  r̥ammatinɤs  ;  r̥apʰidɤtʰeke  ;  r̥itʰrɤn  ;  r̥etɤrikɤs  ;  r̥inɤtɤrɤs  ;  r̥ytʰmɤs  ;  r̥yparopʰaɡɤs  ;  r̥okʰmɤs  ;  r̥atʰymɤs  ;  r̥ɤde  ;  