We are going to solemnly compare the evolution between greek and greek**************************************************

akis   ->    ɒkuz
ɛna   ->    ɔn͜nɒ
is   ->    uz
llo   ->    llo
tatos   ->    dɒdoɬʷ
os   ->    oɬʷ
ɛɡɛ   ->    ɔɡɔ
ɛɡistʰos   ->    ɔɡuzdʰoɬʷ
ɛtʰalos   ->    ɔdʰɒl̥oɬʷ
ɛolos   ->    ɔoloɬʷ
awɡias   ->    ɒwɡuɒz
awlis   ->    ɒwluz
aʍtonoe   ->    ɒʍʰdon͜noo
aʍksumon   ->    ɒʍʰkzu̥mon͜n
baal   ->    bɒɒl̥
balbura   ->    bɒn͜l̥bʊ̜̥rɒ
bɛrɡa   ->    bɔrʰɡɒ
baktria   ->    bɒkdrʰuɒ
betriakon   ->    bodrʰuɒko̥n͜n
byotos   ->    byodoɬʷ
bottiɛy   ->    bodduɔy
budion   ->    bʊduon͜n
brɛnɛ   ->    l̟̟̟̟rʰɔn͜nɔ
brawron   ->    l̟̟̟̟rʰɒwrʰon͜n
breʍky   ->    l̟̟̟̟rʰoʍʰky
bryklike   ->    l̟̟̟̟rʰykluko
byznɛy   ->    byzn͜nɔy
bolkon   ->    bolko̥n͜n
bosporos   ->    boɬʷporoɬʷ
ɡabriel   ->    ɡɒl̟̟̟̟rʰuol
ɡatʰɛɛ   ->    ɡɒdʰɔɔ
ɡɛnnesarɛt   ->    ɡɔn͜nn͜nozɒrɔd
ɡɛrenios   ->    ɡɔron͜nuoɬʷ
ɡeryonas   ->    ɡoryon͜nɒz
ɡolɡotʰa   ->    ɡolɡodʰɒ
ɡorɡias   ->    ɡorʰɡuɒz
ɡorillɛ   ->    ɡorullɔ
dapʰne   ->    dɒpʰn͜no
dipɛa   ->    dupɒɒ
dirpʰys   ->    durʰpʰyz
dadakes   ->    dɒdɒkoz
damaskos   ->    dɒm͜mɒzko̥ɬʷ
ðanaβi   ->    ðɒn͜nɒvʷu
dinolokʰos   ->    dun͜nolokʰoɬʷ
deʍs   ->    doʍʰz
demaratos   ->    dom͜mɒrɒdoɬʷ
demoklides   ->    dom͜mokludoz
demopʰilos   ->    dom͜mopʰuloɬʷ
derusiɛy   ->    doru̥ɬʷuɔy
dionysios   ->    duon͜ny̥zuoɬʷ
dioskuros   ->    duoɬʷku̥roɬʷ
domitios   ->    domuduoɬʷ
drilon   ->    drʰulon͜n
dorimakʰos   ->    dorum͜mʰɒkʰoɬʷ
ilitʰya   ->    uludʰyɒ
eʍtʰymɛnes   ->    oʍʰn͜dʰʏmɔn͜noz
eʍkles   ->    oʍʰkloz
ewrykles   ->    owrʰykloz
ewropa   ->    owrʰopɒ
eʍkʰenor   ->    oʍʰkʰon͜norʰ
ewmɛos   ->    owmɔoɬʷ
zaŋkle   ->    zɒŋ͜ŋ̊klo
zan   ->    zɒn͜n
zbɛltʰiurdos   ->    zbɔldʰuurʰdoɬʷ
zɛlpʰa   ->    zɔlpʰɒ
zekas   ->    zokɒz
zenobios   ->    zon͜nobuoɬʷ
tʰarybis   ->    dʰɒry̥buz
tʰapsakos   ->    dʰɒpzɒko̥ɬʷ
tʰɛmis   ->    dʰɔm͜muz
tʰɛoɡnis   ->    dʰɔoɡn͜nuz
tʰɛrme   ->    dʰɔrʰmo
tʰizbe   ->    dʰuzbo
tʰɛsprotos   ->    dʰɔzl̥̟̟̟̟rʰodoɬʷ
tʰɛopʰrastos   ->    dʰɔol̥̟̟̟̟ʰrʰɒzdoɬʷ
tʰeramɛnes   ->    dʰorɒm͜mɔn͜noz
tʰukydides   ->    dʰʊkʏdudoz
tʰraks   ->    dʰrʰɒkz
tʰreks   ->    dʰrʰokz
kabiry   ->    kɒbury
kalkʰas   ->    kɒn͜lʰkʰɒz
kamiros   ->    kɒm͜muroɬʷ
kantabry   ->    kɒn͜ndɒl̟̟̟̟rʰy
karbon   ->    kɒrbon͜n
karussa   ->    kɒruɬʷzɒ
karpis   ->    kɒrpuz
kastabos   ->    kɒzdɒboɬʷ
katon   ->    kɒdon͜n
kain   ->    kɒun͜n
kɛrkyra   ->    kɒrkʏrɒ
ker   ->    korʰ
kirke   ->    kurʰko
kadmeis   ->    kɒdmouz
kalpurnios   ->    kɒn͜lʰpurʰn͜nuoɬʷ
kandake   ->    kɒn͜ndɒko
kassandra   ->    kɒzzɒn͜ndrʰɒ
kaiapʰas   ->    kɒuɒpʰɒz
kɛŋkʰrɛɛ   ->    kɒŋ͜ŋkʰrʰɔɔ
kepʰisos   ->    kopʰuzoɬʷ
kimmɛrios   ->    kum͜mʰmɔruoɬʷ
klɛanor   ->    klɔɒn͜norʰ
klɛopʰon   ->    klɔopʰon͜n
klɛombrotos   ->    klɔoml̟̟̟̟rʰodoɬʷ
klodios   ->    kloduoɬʷ
koptos   ->    ko̥pdoɬʷ
kordybe   ->    ko̥rʰdʏbo
kudetos   ->    ku̥dodoɬʷ
kritobulos   ->    krʰudobʊloɬʷ
krossɛe   ->    krʰoɬʷzɔo
kydantidɛ   ->    kʏdɒn͜ndudɔ
kydonia   ->    kʏdon͜nuɒ
kottas   ->    ko̥ddɒz
kyr̥r̥os   ->    kyɽrʷʰdʰoɬʷ
kos   ->    ko̥ɬʷ
ladon   ->    lɒdon͜n
lakmon   ->    lɒkmon͜n
larisa   ->    lɒruzɒ
lɛbɛdos   ->    lɔbɔdoɬʷ
lissos   ->    luzzoɬʷ
lampsakenos   ->    lɒm͜mpzɒkon͜noɬʷ
lasɛa   ->    lɒzɔɒ
lɛksipʰanes   ->    lɔkzupʰɒn͜noz
lɛtriny   ->    lɔdrʰun͜ny
leʍkanos   ->    loʍʰkɒn͜noɬʷ
leʍkotʰɛa   ->    loʍʰko̥dʰɔɒ
lɛonides   ->    lɔon͜nudoz
libyrnos   ->    lubyrʰn͜noɬʷ
likinnia   ->    lukun͜nn͜nuɒ
limenarɡoos   ->    lum͜mʰon͜nɒrʰɡooɬʷ
lusios   ->    lu̥ɬʷuoɬʷ
lykie   ->    ly̥kuo
lykabettos   ->    ly̥kɒboddoɬʷ
lystra   ->    lyzdrʰɒ
maɡdolos   ->    mɒɡdoloɬʷ
madytos   ->    mɒdʏdoɬʷ
mallios   ->    mɒn͜l̥luoɬʷ
maria   ->    mɒruɒ
marion   ->    mɒruon͜n
mɛletos   ->    mɔlodoɬʷ
mɛmnon   ->    mɔm͜mn͜non͜n
maɡnesia   ->    mɒɡn͜nozuɒ
makaria   ->    mɒkɒruɒ
malao   ->    mɒn͜l̥ɒo
manasses   ->    mɒn͜nɒzzoz
mantineʍs   ->    mɒn͜ndun͜noʍʰz
marakanda   ->    mɒrɒkɒn͜ndɒ
marmarion   ->    mɒrʰmɒruon͜n
massalia   ->    mɒzzɒn͜l̥uɒ
makʰanidas   ->    mɒkʰɒn͜nudɒz
mɛɡalehɛllas   ->    mɔɡɒl̥ohɒllɒz
mɛlite   ->    mɔludo
mɛrope   ->    mɔropo
mɛssene   ->    mɔzzon͜no
mɛtapontios   ->    mɔdɒpon͜nduoɬʷ
melieʍs   ->    moluoʍʰz
minturne   ->    mun͜ndurʰn͜no
mnewis   ->    mn͜noʍuz
morpʰeʍs   ->    morʰpʰoʍʰz
munykʰion   ->    mu̥n͜ny̥kʰuon͜n
mysia   ->    my̥zuɒ
myra   ->    my̥rɒ
naɡidos   ->    n͜nɒɡudoɬʷ
naparis   ->    n͜nɒpɒruz
narnia   ->    n͜nɒrʰn͜nuɒ
nɛarkʰos   ->    n͜nɔɒrʰkʰoɬʷ
nɛmɛsis   ->    n͜nɔm͜mɔzuz
nɛpos   ->    n͜nɔpoɬʷ
nikarkʰos   ->    n͜nukɒrkʰoɬʷ
naʍkratis   ->    n͜nɒʍʰkrʰɒduz
neleʍs   ->    n͜noloʍʰz
nikolaos   ->    n͜nuko̥lɒoɬʷ
nomantinos   ->    n͜nomɒn͜ndun͜noɬʷ
numɛrios   ->    n͜nu̥mɔruoɬʷ
nisos   ->    n͜nuzoɬʷ
ksois   ->    kzouz
ydipus   ->    y̥dupuɬʷ
yklides   ->    ykludoz
yniadɛ   ->    y̥n͜nuɒdɔ
yaɡros   ->    yɒɡrʰoɬʷ
uindiks   ->    uun͜ndukz
uaros   ->    uɒroɬʷ
pakoros   ->    pɒko̥roɬʷ
panemos   ->    pɒn͜nom͜moɬʷ
panormos   ->    pɒn͜norʰmoɬʷ
parmys   ->    pɒrmyz
pɛlla   ->    pɒllɒ
pɛrɡe   ->    pɒrɡo
pelekɛs   ->    polokɒz
piɛrɛs   ->    puɔrɔz
padɛy   ->    pɒdɔy
palɛstine   ->    pɒl̥ɒzdun͜no
palis   ->    pɒl̥uz
pallene   ->    pɒn͜l̥lon͜no
panatʰenaikos   ->    pɒn͜nɒdʰon͜nɒuko̥ɬʷ
paraskewe   ->    pɒrɒzkowo
partʰia   ->    pɒrdʰuɒ
pasikles   ->    pɒzukloz
papʰlaɡonia   ->    pɒpʰlɒɡon͜nuɒ
pakʰon   ->    pɒkʰon͜n
piritʰus   ->    purudʰuɬʷ
piraeʍs   ->    purɒoʍʰz
pɛlazɡikos   ->    pɒlɒzɡuko̥ɬʷ
pɛloponnesios   ->    pɒlopon͜nn͜nozuoɬʷ
pɛriklymɛnos   ->    pɒruklœ̞mɔn͜noɬʷ
pɛrtinaks   ->    pɒrdun͜nɒkz
pikenos   ->    pukon͜noɬʷ
pitane   ->    pudɒn͜no
pnewmatohaɡion   ->    pn͜nowmɒdohɒɡuon͜n
polykso   ->    polykzo
polydoros   ->    poly̥doroɬʷ
porpʰyrion   ->    porʰpʰʏruon͜n
potidɛa   ->    podudɔɒ
preksaspes   ->    l̥̟̟̟̟rʰokzɒzpoz
prokonnesos   ->    l̥̟̟̟̟rʰoko̥n͜nn͜nozoɬʷ
prytos   ->    l̥̟̟̟̟rʰy̥doɬʷ
pytʰaɡorikos   ->    pʏdʰɒɡoruko̥ɬʷ
pontos   ->    pon͜ndoɬʷ
pylos   ->    pʏloɬʷ
sardis   ->    zɒrʰduz
ser   ->    zorʰ
sɛpros   ->    zɔl̥̟̟̟̟rʰoɬʷ
salɡaneʍs   ->    zɒn͜l̥ɡɒn͜noʍʰz
salonios   ->    zɒl̥on͜nuoɬʷ
samosata   ->    zɒm͜moɬʷɒdɒ
saraŋɡɛ   ->    zɒrɒŋ͜ŋɡɔ
satan   ->    zɒdɒn͜n
sɛleʍkides   ->    zɔloʍʰkudoz
sɛlinus   ->    zɔlun͜nuɬʷ
sekuanos   ->    zoku̥ɒn͜noɬʷ
stʰɛno   ->    zdʰɔn͜no
sintos   ->    zun͜ndoɬʷ
sirakeny   ->    zurɒkon͜ny
skidros   ->    zkudrʰoɬʷ
skylake   ->    zkʏlɒko
zmila   ->    zmulɒ
zmyrna   ->    zmyrʰn͜nɒ
solus   ->    zoluɬʷ
suda   ->    zu̥dɒ
strombikʰides   ->    zdrʰombukʰudoz
styllaŋɡion   ->    zdyllɒŋ͜ŋɡuon͜n
styks   ->    zdykz
syrakusɛ   ->    zy̥rɒku̥ɬʷɒ
sosiɡɛnes   ->    zoɬʷuɡɔn͜noz
sozusa   ->    zozu̥ɬʷɒ
sestos   ->    zozdoɬʷ
sinɛ   ->    zun͜nɔ
syros   ->    zy̥roɬʷ
tanaɡra   ->    dɒn͜nɒɡrʰɒ
tartaros   ->    dɒrʰdɒroɬʷ
tɛmpe   ->    dɔm͜mpo
telɛpʰos   ->    dolɔpʰoɬʷ
tiron   ->    duron͜n
taltʰybios   ->    dɒn͜l̥dʰʏbuoɬʷ
tarkynios   ->    dɒrʰkʏn͜nuoɬʷ
tɛlamon   ->    dɔlɒm͜mon͜n
tɛlmessos   ->    dɔlmozzoɬʷ
tɛrpsikʰora   ->    dɔrʰpzukʰorɒ
terie   ->    doruo
titʰronion   ->    dudʰrʰon͜nuon͜n
timotʰɛos   ->    dum͜mʰodʰɔoɬʷ
titanis   ->    dudɒn͜nuz
tusklanos   ->    duɬʷklɒn͜noɬʷ
trapɛzus   ->    drʰɒpɒzuɬʷ
traianos   ->    drʰɒuɒn͜noɬʷ
troɡilos   ->    drʰoɡuloɬʷ
troos   ->    drʰooɬʷ
tyndarɛos   ->    dyn͜ndɒrɔoɬʷ
tyrambɛ   ->    dʏrɒm͜mbɔ
pʰarbɛtʰos   ->    pʰɒrbɔdʰoɬʷ
pʰabrikios   ->    pʰɒl̟̟̟̟rʰukuoɬʷ
pʰɛdria   ->    pʰɔdrʰuɒ
pʰɛstos   ->    pʰɔzdoɬʷ
pʰarnabazos   ->    pʰɒrn͜nɒbɒzoɬʷ
pʰɛrɛ   ->    pʰɔrɔ
pʰilaidɛ   ->    pʰulɒudɔ
pʰlɛɡyas   ->    pʰlɔɡyɒz
pʰlius   ->    pʰluuɬʷ
pʰynike   ->    pʰʏn͜nuko
pʰrɛɡɛlla   ->    l̥̟̟̟̟ʰrʰɔɡɔllɒ
pʰryɡia   ->    l̥̟̟̟̟ʰrʰy̥ɡuɒ
pʰyle   ->    pʰʏlo
pʰytia   ->    pʰʏduɒ
pʰorkos   ->    pʰorʰko̥ɬʷ
pʰeliks   ->    pʰolukz
kʰaon   ->    kʰɒon͜n
kʰabrias   ->    kʰɒl̟̟̟̟rʰuɒz
kʰɛronia   ->    kʰɔron͜nuɒ
kʰalastra   ->    kʰɒl̥ɒzdrʰɒ
kʰanaan   ->    kʰɒn͜nɒɒn͜n
kʰaridemos   ->    kʰɒrudom͜moɬʷ
kʰrysis   ->    kʰrʰy̥zuz
kʰromios   ->    kʰrʰomuoɬʷ
kʰorsos   ->    kʰorʰzoɬʷ
psessiy   ->    pzozzuy
psammetikʰos   ->    pzɒm͜mmodukʰoɬʷ
psyrie   ->    pzy̥ruo
ɛɡialopʰylaks   ->    ɔɡuɒl̥opʰʏlɒkz
ɛdɛomɛ   ->    ɔdɔomɔ
ɛdo   ->    ɔdo
ɛskʰyno   ->    ɔzkʰʏn͜no
ɛtizo   ->    ɔduzo
hɛrɛsiotes   ->    hɒrɔzuodoz
ɛtʰ   ->    ɔdʰ
ɛtʰusa   ->    ɔdʰʊɬʷɒ
ɛluros   ->    ɔlu̥roɬʷ
ɛnymɛ   ->    ɔn͜ny̥mɔ
ɛstʰesis   ->    ɔzdʰozuz
ɛpsa   ->    ɔpzɒ
aʍtoɛpitʰymia   ->    ɒʍʰdoɔpudʰʏmuɒ
aʍtokʰtʰon   ->    ɒʍʰdokʰdʰon͜n
aʍtʰ   ->    ɒʍʰdʰ
aʍt   ->    ɒʍʰd
badios   ->    bɒduoɬʷ
ballo   ->    bɒn͜l̥lo
barbaks   ->    bɒrʰbɒkz
bɛbelos   ->    bɔboloɬʷ
beks   ->    bokz
bɛno   ->    bɔn͜no
batʰykolpos   ->    bɒdʰʏko̥lʰpoɬʷ
balanion   ->    bɒl̥ɒn͜nuon͜n
baptizmos   ->    bɒpduzmoɬʷ
barys   ->    bɒryz
basilewo   ->    bɒzulowo
bassara   ->    bɒzzɒrɒ
batiake   ->    bɒduɒko
βattoloɣia   ->    vʷɒddoloxʷuɒ
bdɛllion   ->    bdɔlluon͜n
bɛlone   ->    bɔlon͜no
bibliotʰeke   ->    bubluodʰoko
bizakion   ->    buzɒkuon͜n
bios   ->    buoɬʷ
blɛpo   ->    blɔpo
blabɛros   ->    blɒbɔroɬʷ
blastos   ->    blɒzdoɬʷ
blisteris   ->    bluzdoruz
blomos   ->    blomoɬʷ
boetʰia   ->    boodʰuɒ
borboryɡmos   ->    borʰboryɡmoɬʷ
bukoryza   ->    bʊko̥ry̥zɒ
bustropʰedon   ->    buɬʷdrʰopʰodon͜n
bulomɛ   ->    bʊlomɔ
buprestis   ->    bul̥̟̟̟̟rʰozduz
butyron   ->    bʊdʏron͜n
braŋkʰos   ->    l̟̟̟̟rʰɒŋ͜ŋkʰoɬʷ
brime   ->    l̟̟̟̟rʰum͜mʰo
brotolyɡos   ->    l̟̟̟̟rʰodoly̥ɡoɬʷ
brykʰema   ->    l̟̟̟̟rʰy̥kʰom͜mɒ
byblion   ->    bybluon͜n
bytʰos   ->    bʏdʰoɬʷ
bolites   ->    boludoz
baris   ->    bɒruz
be   ->    bo
ɡalas   ->    ɡɒl̥ɒz
ɡalos   ->    ɡɒl̥oɬʷ
ɡiŋɡros   ->    ɡuŋ͜ŋɡrʰoɬʷ
ɡɛon   ->    ɡɔon͜n
ɡalenos   ->    ɡɒl̥on͜noɬʷ
ɡampsonyks   ->    ɡɒm͜mpzon͜nykz
ɡaster   ->    ɡɒzdorʰ
ɡaʍsos   ->    ɡɒʍʰzoɬʷ
ɡiton   ->    ɡudon͜n
ɡɛlyos   ->    ɡɔlyoɬʷ
ɡɛnɛtor   ->    ɡɔn͜nɔdorʰ
ɡɛnɛtʰliakos   ->    ɡɔn͜nɔdʰluɒko̥ɬʷ
ɡɛranion   ->    ɡɔrɒn͜nuon͜n
ɡɛr̥r̥okʰɛlone   ->    ɡɔɽrʷʰdʰokʰɔlon͜no
ɡlamos   ->    ɡlɒm͜moɬʷ
ɡlaʍkopis   ->    ɡlɒʍʰko̥puz
ɡlykys   ->    ɡly̥kyz
ɡlossis   ->    ɡloɬʷzuz
ɡlinos   ->    ɡlun͜noɬʷ
ɡnotɛra   ->    ɡn͜nodɔrɒ
ɡnostikos   ->    ɡn͜noɬʷduko̥ɬʷ
ɡones   ->    ɡon͜noz
ɡrabion   ->    ɡrʰɒbuon͜n
ɡrao   ->    ɡrʰɒo
ɡramme   ->    ɡrʰɒm͜mmo
ɡryks   ->    ɡrʰykz
ɡylios   ->    ɡʏluoɬʷ
ɡynɛkonitis   ->    ɡʏn͜nɔko̥n͜nuduz
ɡypsinos   ->    ɡypzun͜noɬʷ
dɛ   ->    dɔ
dɛkatos   ->    dɔkɒdoɬʷ
dɛlpʰaks   ->    dɔlpʰɒkz
dɛon   ->    dɔon͜n
dɛrkomɛ   ->    dɔrʰko̥mɔ
dɛro   ->    dɔro
dɛtrosyne   ->    dɔdrʰoɬʷy̥n͜no
daktyliotʰeke   ->    dɒkdœ̞luodʰoko
danistes   ->    dɒn͜nuzdoz
dardɛni   ->    dɒr̥ʰdɔn͜nu
dasia   ->    dɒzuɒ
datɛomɛ   ->    dɒdɔomɔ
diktikos   ->    dukduko̥ɬʷ
dire   ->    duro
dɛndillo   ->    dɔn͜ndullo
deleter   ->    dolodorʰ
demopitʰekos   ->    dom͜mopudʰoko̥ɬʷ
diabolos   ->    duɒboloɬʷ
diazoma   ->    duɒzomɒ
dialimma   ->    duɒl̥um͜mʰmɒ
diastasis   ->    duɒzdɒzuz
diakonɛo   ->    duɒko̥n͜nɔo
dialyo   ->    duɒn͜l̥yo
dianyo   ->    duɒn͜nyo
diar̥r̥ɛo   ->    duɒɽ̊r̥ʰdʰɔo
diapʰanes   ->    duɒpʰɒn͜noz
diakʰorizo   ->    duɒkʰoruzo
ditʰyrambikos   ->    dudʰʏrɒm͜mbuko̥ɬʷ
dikɛosyne   ->    dukɒoɬʷy̥n͜no
diktamninos   ->    dukdɒm͜mn͜nun͜noɬʷ
dineis   ->    dun͜nouz
diykodomɛo   ->    duy̥ko̥domɔo
dipseros   ->    dupzoroɬʷ
doassato   ->    doɒzzɒdo
dokɛo   ->    dokɒo
dolikʰos   ->    dolukʰoɬʷ
doksazo   ->    dokzɒzo
dorkas   ->    dorʰkɒz
dotikos   ->    doduko̥ɬʷ
dupɛo   ->    dʊpɒo
draɡma   ->    drʰɒɡmɒ
drakontios   ->    drʰɒko̥n͜nduoɬʷ
drastikos   ->    drʰɒzduko̥ɬʷ
dropis   ->    drʰopuz
dryops   ->    drʰyopz
dyokɛdɛka   ->    dyokɒdɔkɒ
dyskɛlados   ->    dyzkɒlɒdoɬʷ
dystykʰia   ->    dyzdʏkʰuɒ
deɡma   ->    doɡmɒ
doma   ->    domɒ
idetikos   ->    udoduko̥ɬʷ
ik   ->    uk
irenarkʰes   ->    uron͜nɒrʰkʰoz
isɛrkʰomɛ   ->    uzɔrʰkʰomɔ
himatanopɛriballos   ->    hum͜mʰɒdɒn͜nopɒrubɒn͜l̥loɬʷ
ikosi   ->    uko̥ɬʷu
hios   ->    huoɬʷ
ewɛ   ->    owɔ
ewdɛmon   ->    owdɔm͜mon͜n
eʍpɛdeʍsia   ->    oʍʰpɒdoʍʰzuɒ
ewrypɛdilos   ->    owrʰy̥pɒduloɬʷ
ewronotos   ->    owrʰon͜nodoɬʷ
eʍpʰronɛon   ->    oʍʰl̥̟̟̟̟ʰrʰon͜nɔon͜n
eʍporos   ->    oʍʰporoɬʷ
eʍsɛlmos   ->    oɺ̥̟̟̟̟ʰzɔlmoɬʷ
ewnis   ->    own͜nuz
eʍtɛ   ->    oɺ̥̟̟̟̟ʰdɔ
ziŋɡos   ->    zuŋ͜ŋ̊ɡoɬʷ
zewɡnymi   ->    zowɡn͜ny̥mu
zoɡanes   ->    zoɡɒn͜noz
zyɡinos   ->    zy̥ɡun͜noɬʷ
zonnymi   ->    zon͜nn͜ny̥mu
zoo   ->    zoo
zodion   ->    zoduon͜n
tʰalpsis   ->    dʰɒl̥pzuz
tʰɛsis   ->    dʰɔzuz
tʰɛtes   ->    dʰɔdoz
tʰalassɛɡle   ->    dʰɒl̥ɒzzɔɡlo
tʰalɛros   ->    dʰɒl̥ɒroɬʷ
tʰanatepʰoros   ->    dʰɒn͜nɒdopʰoroɬʷ
tʰɛatrokratia   ->    dʰɔɒdrʰokrʰɒduɒ
tʰɛoloɡos   ->    dʰɔoloɡoɬʷ
tʰɛopropɛo   ->    dʰɔol̥̟̟̟̟rʰopɒo
tʰɛoros   ->    dʰɔoroɬʷ
tʰios   ->    dʰuoɬʷ
tʰeriotes   ->    dʰoruodoz
tʰolɛros   ->    dʰolɔroɬʷ
tʰridaks   ->    dʰrʰudɒkz
tʰrawma   ->    dʰrʰɒwmɒ
tʰronon   ->    dʰrʰon͜non͜n
tʰyroros   ->    dʰʏroroɬʷ
tʰymarnon   ->    dʰʏmɒrʰn͜non͜n
tʰymon   ->    dʰʏmon͜n
tʰyrazɛ   ->    dʰʏrɒzɔ
tʰyo   ->    dʰyo
tʰoreks   ->    dʰorokz
tʰelys   ->    dʰolyz
tʰibis   ->    dʰubuz
kammaros   ->    kɒm͜mmɒroɬʷ
kampsa   ->    kɒm͜mpzɒ
kapɛtos   ->    kɒpɒdoɬʷ
karenon   ->    kɒron͜non͜n
kartos   ->    kɒrdoɬʷ
karpʰos   ->    kɒrpʰoɬʷ
kata   ->    kɒdɒ
kɛles   ->    kɒloz
kɛmmor   ->    kɒm͜mmorʰ
kɛrtʰios   ->    kɒrdʰuoɬʷ
kɛrkʰne   ->    kɒrkʰn͜no
kiŋklos   ->    kuŋ͜ŋkloɬʷ
kisirnis   ->    kuzurʰn͜nuz
kɛrios   ->    kɒruoɬʷ
katʰ   ->    kɒdʰ
katʰistemi   ->    kɒdʰuzdom͜mu
katʰartikos   ->    kɒdʰɒrʰduko̥ɬʷ
kakkabe   ->    kɒkkɒbo
kakomyros   ->    kɒko̥my̥roɬʷ
kakos   ->    kɒko̥ɬʷ
kalamotʰeke   ->    kɒl̥ɒm͜modʰoko
kalia   ->    kɒn͜l̥uɒ
kallitʰriks   ->    kɒn͜l̥ludʰrʰukz
kallipɛtalon   ->    kɒn͜l̥lupɒdɒl̥on͜n
kantʰiɛ   ->    kɒn͜ndʰuɔ
karkinos   ->    kɒrkun͜noɬʷ
kasia   ->    kɒzuɒ
kataɡnymi   ->    kɒdɒɡn͜ny̥mu
katastɛɡos   ->    kɒdɒzdɔɡoɬʷ
katɛpɛpʰnon   ->    kɒdɔpɒpʰn͜non͜n
katalɛɡo   ->    kɒdɒl̥ɒɡo
katanaŋke   ->    kɒdɒn͜nɒŋ͜ŋko
katapraktikon   ->    kɒdɒl̥̟̟̟̟rʰɒkduko̥n͜n
katapʰronetikos   ->    kɒdɒl̥̟̟̟̟ʰrʰon͜noduko̥ɬʷ
katɛtyks   ->    kɒdɔdykz
katekʰetes   ->    kɒdokʰodoz
katopistʰɛn   ->    kɒdopuzdʰɔn͜n
kaʍsia   ->    kɒʍʰzuɒ
kakʰɛktes   ->    kɒkʰɔkdoz
kɛdrites   ->    kɒdrʰudoz
kɛlɛnos   ->    kɒlɔn͜noɬʷ
kɛntɛo   ->    kɒn͜ndɔo
kɛramis   ->    kɒrɒm͜muz
kɛratɛa   ->    kɒrɒdɔɒ
keʍtʰo   ->    koʍʰn͜dʰo
kis   ->    kuz
kerylos   ->    kory̥loɬʷ
kikymis   ->    kukʏmuz
kinɛo   ->    kun͜nɔo
kinyra   ->    kun͜ny̥rɒ
kladinos   ->    klɒdun͜noɬʷ
kletʰrinos   ->    klodʰrʰun͜noɬʷ
klitoris   ->    kludoruz
kletos   ->    klodoɬʷ
klisie   ->    kluzuo
klydon   ->    kly̥don͜n
knips   ->    kn͜nupz
knekos   ->    kn͜noko̥ɬʷ
kyloma   ->    kʏlomɒ
kokkotʰraʍstes   ->    ko̥kko̥dʰrʰɒʍʰzdoz
kolɛoptɛros   ->    ko̥lɔopdɔroɬʷ
kolymbas   ->    ko̥lymbɒz
kolobion   ->    ko̥lobuon͜n
komoon   ->    ko̥moon͜n
konie   ->    ko̥n͜nuo
kopadion   ->    ko̥pɒduon͜n
koriannon   ->    ko̥ruɒn͜nn͜non͜n
korone   ->    ko̥ron͜no
kozmopolitas   ->    ko̥zmopoludɒz
kuris   ->    ku̥ruz
kyos   ->    kyoɬʷ
krɛmbala   ->    krʰɔm͜mbɒl̥ɒ
kreɡyos   ->    krʰoɡyoɬʷ
kritʰinos   ->    krʰudʰun͜noɬʷ
krinon   ->    krʰun͜non͜n
krɛpnos   ->    krʰɔpn͜noɬʷ
kranion   ->    krʰɒn͜nuon͜n
kratɛronyks   ->    krʰɒdɔron͜nykz
kratys   ->    krʰɒdyz
kresɛra   ->    krʰozɔrɒ
krokomaɡma   ->    krʰoko̥mɒɡmɒ
krupɛzɛ   ->    krʰɔ̞pɒzɔ
krypʰa   ->    krʰœ̞pʰɒ
ktaomɛ   ->    kdɒomɔ
ktisis   ->    kduzuz
ktenos   ->    kdon͜noɬʷ
kyanoptɛros   ->    kyɒn͜nopdɔroɬʷ
kybɛrnetikos   ->    kʏbɔrʰn͜noduko̥ɬʷ
kykɛon   ->    kʏkɒon͜n
kyminotʰeke   ->    kʏmun͜nodʰoko
kynidion   ->    kʏn͜nuduon͜n
kynokrambe   ->    kʏn͜nokrʰɒm͜mbo
kynokkʰalke   ->    kʏn͜nokkʰɒn͜lʰko
kyprinos   ->    kyl̥̟̟̟̟rʰun͜noɬʷ
kobios   ->    ko̥buoɬʷ
kokyo   ->    ko̥kyo
koŋɡion   ->    ko̥ŋɡuon͜n
kolos   ->    ko̥loɬʷ
koros   ->    ko̥roɬʷ
korymbos   ->    ko̥rymboɬʷ
kopsa   ->    ko̥pzɒ
kyknos   ->    kykn͜noɬʷ
kyritʰra   ->    kʏrudʰrʰɒ
kyma   ->    kʏmɒ
kypʰi   ->    kʏpʰu
koma   ->    ko̥mɒ
labrys   ->    lɒl̟̟̟̟rʰyz
lambda   ->    lɒm͜mbdɒ
lapatʰos   ->    lɒpɒdʰoɬʷ
lainos   ->    lɒun͜noɬʷ
lien   ->    luon͜n
linon   ->    lun͜non͜n
laŋkia   ->    lɒŋ͜ŋkuɒ
latʰrɛos   ->    lɒdʰrʰɔoɬʷ
lalɛo   ->    lɒn͜l̥ɒo
lakʰanotʰeke   ->    lɒkʰɒn͜nodʰoko
lawra   ->    lɒwrʰɒ
lɛpʰos   ->    lɔpʰoɬʷ
libo   ->    lubo
liturɡia   ->    ludurʰɡuɒ
lɛktikos   ->    lɔkduko̥ɬʷ
lɛptoɡɛos   ->    lɔpdoɡɔoɬʷ
lewros   ->    lowrʰoɬʷ
libanotʰeke   ->    lubɒn͜nodʰoko
loɡomakʰia   ->    loɡomɒkʰuɒ
lypos   ->    ly̥poɬʷ
lordos   ->    lorʰdoɬʷ
lyɡros   ->    lyɡrʰoɬʷ
lykoskordon   ->    ly̥ko̥ɬʷko̥rʰdon͜n
lypros   ->    lyl̥̟̟̟̟rʰoɬʷ
lysimakʰion   ->    ly̥zum͜mʰɒkʰuon͜n
lorymnon   ->    lorymn͜non͜n
lokʰos   ->    lokʰoɬʷ
lobe   ->    lobo
lestia   ->    lozduɒ
lezomɛ   ->    lozomɔ
makir   ->    mɒkurʰ
mastiks   ->    mɒzdukz
mɛɡaron   ->    mɔɡɒron͜n
mɛdomɛ   ->    mɔdomɔ
mɛtʰodos   ->    mɔdʰodoɬʷ
mɛlan   ->    mɔlɒn͜n
mɛlpo   ->    mɔlpo
mɛno   ->    mɔn͜no
mɛtrios   ->    mɔdrʰuoɬʷ
mestor   ->    mozdorʰ
midas   ->    mudɒz
miksis   ->    mukzuz
matʰetewo   ->    mɒdʰodowo
mania   ->    mɒn͜nuɒ
masaomɛ   ->    mɒzɒomɔ
matɛotɛkʰnia   ->    mɒdɔodɔkn͜nuɒ
mapsidios   ->    mɒpzuduoɬʷ
miliɡma   ->    muluɡmɒ
mɛlanuros   ->    mɔlɒn͜nu̥roɬʷ
mɛlimelon   ->    mɔlum͜mʰolon͜n
mɛlaŋkorypʰos   ->    mɔlɒŋ͜ŋko̥ry̥pʰoɬʷ
mɛnɛɛno   ->    mɔn͜nɔɔn͜no
mɛnoikes   ->    mɔn͜noukoz
mɛsolabos   ->    mɔzolɒboɬʷ
mɛtaballo   ->    mɔdɒbɒn͜l̥lo
mɛtanastasis   ->    mɔdɒn͜nɒzdɒzuz
mɛtapʰonɛo   ->    mɔdɒpʰon͜nɔo
mɛtykia   ->    mɔdʏkuɒ
medamos   ->    modɒm͜moɬʷ
melotris   ->    molodrʰuz
menoides   ->    mon͜noudoz
mekʰanaomɛ   ->    mokʰɒn͜nɒomɔ
mikroloɡia   ->    mukrʰoloɡuɒ
mimɛomɛ   ->    mum͜mʰɔomɔ
mistyllo   ->    muzdyllo
mnesipemon   ->    mn͜nozupom͜mon͜n
molɡos   ->    molɡoɬʷ
molybdɛna   ->    molybdɔn͜nɒ
mone   ->    mon͜no
monarkʰɛo   ->    mon͜nɒr̥ʰkʰɔo
myɡalɛe   ->    my̥ɡɒn͜l̥ɒo
mytʰodes   ->    my̥dʰodoz
myketinos   ->    my̥kodun͜noɬʷ
ewopʰtʰalmos   ->    owopʰn͜dʰɒn͜l̥moɬʷ
myrobalaninos   ->    my̥robɒl̥ɒn͜nun͜noɬʷ
myrsinites   ->    myrʰzun͜nudoz
monops   ->    mon͜nopz
moron   ->    moron͜n
moskʰinos   ->    moɬʷkʰun͜noɬʷ
mokʰtʰos   ->    mokʰdʰoɬʷ
myllos   ->    mylloɬʷ
mystis   ->    myzduz
myops   ->    myopz
morios   ->    moruoɬʷ
medos   ->    modoɬʷ
nartʰeks   ->    n͜nɒrʰdʰokz
napʰtʰa   ->    n͜nɒpʰn͜dʰɒ
nɛomɛ   ->    n͜nɔomɔ
ne   ->    n͜no
nepios   ->    n͜nopuoɬʷ
ninon   ->    n͜nun͜non͜n
nɛ   ->    n͜nɔ
naʍs   ->    n͜nɒʍʰz
nɛkro   ->    n͜nɔkrʰo
nɛkydallos   ->    n͜nɔkʏdɒn͜l̥loɬʷ
newra   ->    n͜nowrʰɒ
nɛpʰɛleɡɛrɛta   ->    n͜nɔpʰɔloɡɔrɔdɒ
nikos   ->    n͜nuko̥ɬʷ
nesiotes   ->    n͜nozuodoz
noɛo   ->    n͜noɔo
nomotʰɛtikos   ->    n͜nomodʰɔduko̥ɬʷ
noseros   ->    n͜noɬʷoroɬʷ
nytʰos   ->    n͜ny̥dʰoɬʷ
nympʰoleptos   ->    n͜nympʰolopdoɬʷ
nystaɡmos   ->    n͜nyzdɒɡmoɬʷ
notinos   ->    n͜nodun͜noɬʷ
noton   ->    n͜nodon͜n
noi   ->    n͜nou
ksɛnos   ->    kzɔn͜noɬʷ
ksantʰoleʍkos   ->    kzɒn͜ndʰoloʍʰko̥ɬʷ
ksɛnia   ->    kzɔn͜nuɒ
ksenos   ->    kzon͜noɬʷ
ksylaloe   ->    kzœ̞lɒn͜l̥oo
ksymplɛo   ->    kzymplɔo
ksynidos   ->    kzœ̞n͜nudoɬʷ
ksynos   ->    kzy̥n͜noɬʷ
ksylon   ->    kzy̥lon͜n
ksyo   ->    kzyo
ykonomos   ->    y̥ko̥n͜nomoɬʷ
ynokʰoe   ->    y̥n͜nokʰoo
ysyinos   ->    y̥zyun͜noɬʷ
ykʰomɛnos   ->    y̥kʰomɔn͜noɬʷ
ykesis   ->    y̥kozuz
ymy   ->    y̥my
hyos   ->    hyoɬʷ
udɛtɛros   ->    u̥dɔdɔroɬʷ
ulɛ   ->    u̥lɔ
urɛo   ->    u̥rɔo
uraniskos   ->    u̥rɒn͜nuzko̥ɬʷ
utis   ->    u̥duz
hunɛka   ->    hu̥n͜nɔkɒ
us   ->    uɬʷ
pantosɛ   ->    pɒn͜ndoɬʷɒ
papraks   ->    pɒl̥̟̟̟̟rʰɒkz
parykos   ->    pɒry̥ko̥ɬʷ
pɛzis   ->    pɒzuz
pɛlɛkys   ->    pɒlɔkyz
pɛmpʰiks   ->    pɒm͜mpʰukz
pɛtrinos   ->    pɒdrʰun͜noɬʷ
pɛpsis   ->    pɒpzuz
peɡnymi   ->    poɡn͜ny̥mu
pere   ->    poro
pimplemi   ->    pum͜mʰplom͜mu
pininos   ->    pun͜nun͜noɬʷ
pion   ->    puon͜n
pɛzo   ->    pɒzo
pɛdion   ->    pɒduon͜n
pɛdaɡoɡia   ->    pɒdɒɡoɡuɒ
paliurinos   ->    pɒl̥uu̥run͜noɬʷ
pammɛɡɛtʰes   ->    pɒm͜mmɔɡɔdʰoz
pantakʰu   ->    pɒn͜ndɒkʰu
parakytis   ->    pɒrɒkʏduz
parapʰrasis   ->    pɒrɒl̥̟̟̟̟ʰrʰɒzuz
parɛrkʰomɛ   ->    pɒrɔrʰkʰomɔ
parɛ   ->    pɒrɔ
parabolany   ->    pɒrɒbolɒn͜ny
paradiɡmatikos   ->    pɒrɒduɡmɒduko̥ɬʷ
paralleloɡrammos   ->    pɒrɒn͜l̥loloɡrʰɒm͜mmoɬʷ
paranomia   ->    pɒrɒn͜nomuɒ
parias   ->    pɒruɒz
par̥r̥esia   ->    pɒɽrʰdʰozuɒ
pastos   ->    pɒzdoɬʷ
patɛomɛ   ->    pɒdɔomɔ
patria   ->    pɒdrʰuɒ
pawla   ->    pɒwlɒ
pɛloris   ->    pɒloruz
pɛntakiskʰiliy   ->    pɒn͜ndɒkuzkʰuluy
pɛntekoste   ->    pɒn͜ndoko̥ɬʷdo
pɛr   ->    pɒr
pɛrizoma   ->    pɒruzomɒ
pɛriballo   ->    pɒrubɒn͜l̥lo
pɛriporpʰyros   ->    pɒruporʰpʰʏroɬʷ
pɛristropʰis   ->    pɒruzdrʰopʰuz
pɛrityŋkʰano   ->    pɒrudyŋkʰɒn͜no
pɛrknos   ->    pɒrkn͜noɬʷ
pɛrsɛa   ->    pɒrzɔɒ
pɛtinos   ->    pɒdun͜noɬʷ
pizma   ->    puzmɒ
pedos   ->    podoɬʷ
pizɡis   ->    puzɡuz
platʰanon   ->    plɒdʰɒn͜non͜n
plasis   ->    plɒzuz
plɛɡma   ->    plɔɡmɒ
plemne   ->    plom͜mn͜no
plezmios   ->    plozmuoɬʷ
platanistinos   ->    plɒdɒn͜nuzdun͜noɬʷ
plɛktane   ->    plɔkdɒn͜no
ploke   ->    ploko
plutos   ->    plu̥doɬʷ
pleɡma   ->    ploɡmɒ
pnoe   ->    pn͜noo
podenɛmos   ->    podon͜nɔm͜moɬʷ
pyetes   ->    pyodoz
pyne   ->    pʏn͜no
polɛmios   ->    polɔm͜muoɬʷ
polios   ->    poluoɬʷ
pollaki   ->    pollɒku
polymatʰes   ->    poly̥mɒdʰoz
polystapʰylos   ->    polyzdɒpʰʏloɬʷ
polyɡalon   ->    poly̥ɡɒl̥on͜n
polypʰlyzbos   ->    polypʰlyzboɬʷ
pompos   ->    pompoɬʷ
porewo   ->    porowo
prɛmnon   ->    l̥̟̟̟̟rʰɔm͜mn͜non͜n
praɡmatikos   ->    l̥̟̟̟̟rʰɒɡmɒduko̥ɬʷ
prapis   ->    l̥̟̟̟̟rʰɒpuz
proɛkʰo   ->    l̥̟̟̟̟rʰoɔkʰo
probɛno   ->    l̥̟̟̟̟rʰobɔn͜no
proɡrapʰe   ->    l̥̟̟̟̟rʰoɡrʰɒpʰo
proorao   ->    l̥̟̟̟̟rʰoorɒo
prosɛkʰo   ->    l̥̟̟̟̟rʰoɬʷɒkʰo
prozdokao   ->    l̥̟̟̟̟rʰozdokɒo
proskenion   ->    l̥̟̟̟̟rʰoɬʷkon͜nuon͜n
prospʰonɛo   ->    l̥̟̟̟̟rʰoɬʷpʰon͜nɔo
proti   ->    l̥̟̟̟̟rʰodu
propʰetizo   ->    l̥̟̟̟̟rʰopʰoduzo
protawles   ->    l̥̟̟̟̟rʰodɒwloz
prototokos   ->    l̥̟̟̟̟rʰododoko̥ɬʷ
propoma   ->    l̥̟̟̟̟rʰopomɒ
prytanis   ->    l̥̟̟̟̟rʰy̥dɒn͜nuz
prinos   ->    l̥̟̟̟̟rʰun͜noɬʷ
ptɛrne   ->    pdɔrʰn͜no
ptisane   ->    pduzɒn͜no
ptyŋks   ->    pdyŋkz
ptoks   ->    pdokz
pyknos   ->    pykn͜noɬʷ
pyre   ->    pʏro
pyramus   ->    pʏrɒm͜muɬʷ
pyrsos   ->    pyrʰzoɬʷ
potʰos   ->    podʰoɬʷ
pornos   ->    porʰn͜noɬʷ
posis   ->    poɬʷuz
potmos   ->    podmoɬʷ
pyanos   ->    pyɒn͜noɬʷ
pyksos   ->    pykzoɬʷ
poles   ->    poloz
poy   ->    poy
saktas   ->    zɒkdɒz
sannas   ->    zɒn͜nn͜nɒz
sapitʰos   ->    zɒpudʰoɬʷ
sarks   ->    zɒrʰkz
satra   ->    zɒdrʰɒ
sɛbas   ->    zɔbɒz
sɛbomɛ   ->    zɔbomɔ
sɛsypʰos   ->    zɔzy̥pʰoɬʷ
sidaros   ->    zudɒroɬʷ
sizo   ->    zuzo
sikyos   ->    zukyoɬʷ
siluros   ->    zulu̥roɬʷ
sisaron   ->    zuzɒron͜n
saɡapenon   ->    zɒɡɒpon͜non͜n
sandalotʰeke   ->    zɒn͜ndɒl̥odʰoko
sarkokele   ->    zɒrʰko̥kolo
satyriskos   ->    zɒdʏruzko̥ɬʷ
sawroktonos   ->    zɒwrʰokdon͜noɬʷ
sison   ->    zuzon͜n
sɛmnos   ->    zɔm͜mn͜noɬʷ
sɛrɡy   ->    zɔrʰɡy
semio   ->    zom͜muo
siɡe   ->    zuɡo
siderurɡos   ->    zudorurʰɡoɬʷ
sition   ->    zuduon͜n
sitonion   ->    zudon͜nuon͜n
siope   ->    zuopo
skaros   ->    zkɒroɬʷ
skalis   ->    zkɒl̥uz
skandalizo   ->    zkɒn͜ndɒl̥uzo
skɛlɛtos   ->    zkɒlɔdoɬʷ
skewazo   ->    zkoʍɒzo
skia   ->    zkuɒ
skiois   ->    zkuouz
skykion   ->    zkʏkuon͜n
skopie   ->    zko̥puo
skolytʰron   ->    zko̥lydʰrʰon͜n
skotos   ->    zko̥doɬʷ
skyros   ->    zkɪroɬʷ
skolos   ->    zko̥loɬʷ
zmao   ->    zmɒo
solinos   ->    zolun͜noɬʷ
sopʰizmos   ->    zopʰuzmoɬʷ
susinos   ->    zu̥ɬʷun͜noɬʷ
spartinos   ->    zpɒrdun͜noɬʷ
spindalos   ->    zpun͜ndɒl̥oɬʷ
spatʰepʰoros   ->    zpɒdʰopʰoroɬʷ
sparɡanion   ->    zpɒrɡɒn͜nuon͜n
spirɛa   ->    zpurɔɒ
spewdo   ->    zpowdo
spodos   ->    zpodoɬʷ
sporos   ->    zporoɬʷ
stɛɡe   ->    zdɔɡo
stilbo   ->    zdulbo
stasiarkʰes   ->    zdɒzuɒrʰkʰoz
stapʰylaɡra   ->    zdɒpʰʏlɒɡrʰɒ
stɛs   ->    zdɔz
stɛlɛa   ->    zdɔlɔɒ
stɛnoo   ->    zdɔn͜noo
stoa   ->    zdoɒ
stykʰioo   ->    zdʏkʰuoo
stokʰazomɛ   ->    zdokʰɒzomɔ
stykʰos   ->    zdʏkʰoɬʷ
striks   ->    zdrʰukz
straŋɡuria   ->    zdrʰɒŋ͜ŋɡʊ̜ruɒ
strateɡia   ->    zdrʰɒdoɡuɒ
stratopɛdon   ->    zdrʰɒdopɒdon͜n
stropʰaliŋks   ->    zdrʰopʰɒl̥uŋ͜ŋkz
stroma   ->    zdrʰomɒ
stypʰo   ->    zdʏpʰo
steriŋks   ->    zdoruŋ͜ŋkz
syŋɡrapʰeʍs   ->    zyŋɡrʰɒpʰoʍʰz
syŋkope   ->    zyŋko̥po
sykopʰantia   ->    zy̥ko̥pʰɒn͜nduɒ
syllɛɡo   ->    zyllɔɡo
symbɛno   ->    zymbɔn͜no
symmakʰɛo   ->    zymmɒkʰɔo
symparataksis   ->    zympɒrɒdɒkzuz
sympotes   ->    zympodoz
synɛrɛsis   ->    zy̥n͜nɔrɔzuz
synapʰes   ->    zy̥n͜nɒpʰoz
synɛksɛrkʰomɛ   ->    zy̥n͜nɔkzɔrʰkʰomɔ
synykizo   ->    zy̥n͜ny̥kuzo
syntɛlia   ->    zyn͜ndɔluɒ
systɛllo   ->    zyzdɔllo
spʰaɡnos   ->    zpʰɒɡn͜noɬʷ
spʰalɛros   ->    zpʰɒl̥ɒroɬʷ
spʰiŋktos   ->    zpʰuŋ͜ŋkdoɬʷ
spʰyzo   ->    zpʰʏzo
skʰɛma   ->    zkʰɔm͜mɒ
skʰalis   ->    zkʰɒl̥uz
skʰinos   ->    zkʰun͜noɬʷ
sybas   ->    zy̥bɒz
sympʰysis   ->    zympʰʏzuz
syntʰɛsis   ->    zyn͜ndʰɔzuz
syinos   ->    zyun͜noɬʷ
soma   ->    zomɒ
sotron   ->    zodrʰon͜n
taksis   ->    dɒkzuz
takʰ   ->    dɒkʰ
tɛ   ->    dɔ
tɛramnon   ->    dɔrɒm͜mn͜non͜n
tɛtriks   ->    dɔdrʰukz
tetʰyon   ->    dodʰyon͜n
tiprassis   ->    dul̥̟̟̟̟rʰɒzzuz
taɡen   ->    dɒɡon͜n
tarasso   ->    dɒrɒzzo
tawros   ->    dɒwrʰoɬʷ
tino   ->    dun͜no
tikʰopʰylaks   ->    dukʰopʰʏlɒkz
tɛleʍtɛos   ->    dɔloɺ̥̟̟̟̟ʰdɔoɬʷ
tɛrmintʰinos   ->    dɔrʰmun͜ndʰun͜noɬʷ
tɛtanos   ->    dɔdɒn͜noɬʷ
tɛtrakyklos   ->    dɔdrʰɒkykloɬʷ
teʍtazo   ->    doʍʰdɒzo
tɛkʰnoɡrapʰos   ->    dɔkʰn͜noɡrʰɒpʰoɬʷ
temɛlɛo   ->    dom͜mɔlɔo
tlemon   ->    dlom͜mon͜n
ty   ->    dy
tomos   ->    domoɬʷ
topikos   ->    dopuko̥ɬʷ
trakʰelos   ->    drʰɒkʰoloɬʷ
trɛpo   ->    drʰɔpo
triɛna   ->    drʰuɔn͜nɒ
tribolos   ->    drʰuboloɬʷ
trizmakar   ->    drʰuzmɒkɒr
tripʰyllon   ->    drʰupʰyllon͜n
traɡɛlapʰos   ->    drʰɒɡɔlɒpʰoɬʷ
triklinion   ->    drʰuklun͜nuon͜n
triodus   ->    drʰuoduɬʷ
tropʰikos   ->    drʰopʰuko̥ɬʷ
trokʰos   ->    drʰokʰoɬʷ
tromos   ->    drʰomoɬʷ
trysis   ->    drʰy̥zuz
tykane   ->    dʏkɒn͜no
tolma   ->    dolmɒ
tornos   ->    dorʰn͜noɬʷ
tossos   ->    doɬʷzoɬʷ
tyrinos   ->    dʏrun͜noɬʷ
tyr̥r̥is   ->    dyɽrʷʰdʰuz
toto   ->    dodo
tilos   ->    duloɬʷ
typʰos   ->    dʏpʰoɬʷ
to   ->    do
hyonos   ->    hyon͜noɬʷ
pʰallɛna   ->    pʰɒn͜l̥lɔn͜nɒ
pʰarsos   ->    pʰɒrzoɬʷ
pʰɛrnion   ->    pʰɔrʰn͜nuon͜n
pʰanos   ->    pʰɒn͜noɬʷ
pʰarkis   ->    pʰɒrkuz
pʰawlos   ->    pʰɒwloɬʷ
pʰi   ->    pʰu
pʰtʰina   ->    pʰn͜dʰun͜nɒ
pʰtʰartos   ->    pʰn͜dʰɒrʰdoɬʷ
pʰtʰonos   ->    pʰn͜dʰon͜noɬʷ
pʰilerɛtmos   ->    pʰulorɔdmoɬʷ
pʰilodoksia   ->    pʰulodokzuɒ
pʰiloksɛnos   ->    pʰulokzɔn͜noɬʷ
pʰilotes   ->    pʰulodoz
pʰlyktɛna   ->    pʰlykdɔn͜nɒ
pʰytao   ->    pʰʏdɒo
pʰoksinos   ->    pʰokzun͜noɬʷ
pʰu   ->    pʰu
pʰrades   ->    l̥̟̟̟̟ʰrʰɒdoz
pʰronesis   ->    l̥̟̟̟̟ʰrʰon͜nozuz
pʰye   ->    pʰyo
pʰyseter   ->    pʰʏzodorʰ
pʰone   ->    pʰon͜no
pʰos   ->    pʰoɬʷ
kʰaliks   ->    kʰɒl̥ukz
kʰaraɡma   ->    kʰɒrɒɡmɒ
kʰɛo   ->    kʰɔo
kʰera   ->    kʰorɒ
kʰalkeres   ->    kʰɒn͜lʰkoroz
kʰalkos   ->    kʰɒn͜lʰko̥ɬʷ
kʰamɛ   ->    kʰɒm͜mɔ
kʰamɛleʍke   ->    kʰɒm͜mɔloʍʰko
kʰamɛplatanos   ->    kʰɒm͜mɔplɒdɒn͜noɬʷ
kʰartotʰeke   ->    kʰɒrdodʰoko
kʰimastron   ->    kʰum͜mʰɒzdrʰon͜n
kʰironiptron   ->    kʰuron͜nupdrʰon͜n
kʰɛlidon   ->    kʰɔludon͜n
kʰɛrmas   ->    kʰɔrʰmɒz
kʰimɛropʰylaks   ->    kʰum͜mʰɔropʰʏlɒkz
kʰlamys   ->    kʰlɒm͜myz
kʰloros   ->    kʰloroɬʷ
kʰole   ->    kʰolo
kʰorawles   ->    kʰorɒwloz
kʰoikos   ->    kouko̥ɬʷ
kʰraomɛ   ->    kʰrʰɒomɔ
kʰrɛos   ->    kʰrʰɔoɬʷ
kʰrestotes   ->    kʰrʰozdodoz
kʰrysolakʰanon   ->    kʰrʰy̥zolɒkʰɒn͜non͜n
kʰrysopʰylaks   ->    kʰrʰy̥zopʰʏlɒkz
kʰylos   ->    kʰʏloɬʷ
kʰytropus   ->    kʰydrʰopuɬʷ
kʰoroɡrapʰos   ->    kʰoroɡrʰɒpʰoɬʷ
psalma   ->    pzɒn͜l̥mɒ
psɛdra   ->    pzɔdrʰɒ
psawrios   ->    pzɒwrʰuoɬʷ
psɛllos   ->    pzɔlloɬʷ
psewdoɡrapʰos   ->    pzowdoɡrʰɒpʰoɬʷ
psewdonymos   ->    pzowdon͜ny̥moɬʷ
psykʰros   ->    pzykʰrʰoɬʷ
psolos   ->    pzoloɬʷ
aw   ->    ɒw
abyrtake   ->    ɒbyrʰdɒko
aɡape   ->    ɒɡɒpo
aɡatʰos   ->    ɒɡɒdʰoɬʷ
aŋɡotʰeke   ->    ɒŋ͜ŋɡodʰoko
aɡɛnɛaloɡetos   ->    ɒɡɔn͜nɔɒl̥oɡodoɬʷ
aŋkon   ->    ɒŋ͜ŋko̥n͜n
aɡnos   ->    ɒɡn͜noɬʷ
aɡore   ->    ɒɡoro
aɡriokinara   ->    ɒɡrʰuokun͜nɒrɒ
aŋkʰistia   ->    ɒŋ͜ŋkʰuzduɒ
aɡonia   ->    ɒɡon͜nuɒ
adarke   ->    ɒdɒrʰko
adɛspotos   ->    ɒdɔzpodoɬʷ
adiabaos   ->    ɒduɒbɒoɬʷ
aɛrɡos   ->    ɒɔrʰɡoɬʷ
akalepʰe   ->    ɒkɒl̥opʰo
akataskewastos   ->    ɒkɒdɒzkoʍɒzdoɬʷ
akidnos   ->    ɒkudn͜noɬʷ
akraes   ->    ɒkrʰɒoz
akrobates   ->    ɒkrʰobɒdoz
alabes   ->    ɒl̥ɒboz
alaomɛ   ->    ɒn͜l̥ɒomɔ
alɛksipʰarmakon   ->    ɒl̥ɒkzupʰɒrmɒko̥n͜n
aletʰie   ->    ɒl̥odʰuo
allelon   ->    ɒn͜l̥lolon͜n
alpʰadion   ->    ɒn͜l̥pʰɒduon͜n
alopeks   ->    ɒl̥opokz
amandalos   ->    ɒm͜mɒn͜ndɒl̥oɬʷ
amɛrɡo   ->    ɒm͜mɔrʰɡo
amblys   ->    ɒm͜mblyz
amybe   ->    ɒm͜my̥bo
ampɛloprason   ->    ɒm͜mpɒlol̥̟̟̟̟rʰɒzon͜n
ampʰiballo   ->    ɒm͜mpʰubɒn͜l̥lo
ampʰipɛnomɛ   ->    ɒm͜mpʰupɒn͜nomɔ
amorɡinos   ->    ɒm͜morʰɡun͜noɬʷ
amyɡdalon   ->    ɒm͜myɡdɒl̥on͜n
amyno   ->    ɒm͜my̥n͜no
anabrosis   ->    ɒn͜nɒl̟̟̟̟rʰoɬʷuz
anaɡo   ->    ɒn͜nɒɡo
anataksis   ->    ɒn͜nɒdɒkzuz
aniketos   ->    ɒn͜nukodoɬʷ
anaisso   ->    ɒn͜nɒuzzo
analɡesia   ->    ɒn͜nɒn͜l̥ɡozuɒ
anamimnesko   ->    ɒn͜nɒm͜mum͜mʰn͜nozko̥
anaskewazo   ->    ɒn͜nɒzkoʍɒzo
andrios   ->    ɒn͜ndrʰuoɬʷ
antʰɛo   ->    ɒn͜ndʰɔo
antʰropoloɡos   ->    ɒn͜ndʰrʰopoloɡoɬʷ
antʰolops   ->    ɒn͜ndʰolopz
anoruo   ->    ɒn͜noruo
antibios   ->    ɒn͜ndubuoɬʷ
antitʰɛton   ->    ɒn͜ndudʰɔdon͜n
antir̥r̥inon   ->    ɒn͜nduɽrʷʰdʰun͜non͜n
aksioprɛpes   ->    ɒkzuol̥̟̟̟̟rʰɔpoz
aorter   ->    ɒorʰdorʰ
apaneʍtʰɛn   ->    ɒpɒn͜noɺ̥̟̟̟̟ʰn͜dʰɔn͜n
apiria   ->    ɒpuruɒ
apɛrisios   ->    ɒpɒruzuoɬʷ
apobasileʍs   ->    ɒpobɒzuloʍʰz
apykia   ->    ɒpʏkuɒ
apokopto   ->    ɒpoko̥pdo
apoplɛo   ->    ɒpoplɔo
aporɛo   ->    ɒporɔo
apostole   ->    ɒpoɬʷdolo
apokʰorɛo   ->    ɒpokʰorɔo
apodrasis   ->    ɒpodrʰɒzuz
apollymi   ->    ɒpolly̥mu
apomaktron   ->    ɒpomɒkdrʰon͜n
apon   ->    ɒpon͜n
arasso   ->    ɒrɒzzo
arbale   ->    ɒrʰbɒl̥o
arɡyrus   ->    ɒrʰɡʏruɬʷ
arɡyrion   ->    ɒrʰɡʏruon͜n
arɡas   ->    ɒrʰɡɒz
areipʰilos   ->    ɒroupʰuloɬʷ
aritʰmɛo   ->    ɒrudʰmɔo
aristeʍs   ->    ɒruzdoʍʰz
arkɛo   ->    ɒrʰkɒo
aryballis   ->    ɒry̥bɒn͜l̥luz
arkʰaŋɡɛlos   ->    ɒrʰkʰɒŋ͜ŋɡɔloɬʷ
arkʰirabdukʰos   ->    ɒrʰkʰurɒbdʊkʰoɬʷ
aroo   ->    ɒroo
astʰɛnɛo   ->    ɒzdʰɔn͜nɔo
askantes   ->    ɒzkɒn͜ndoz
aspis   ->    ɒzpuz
astrape   ->    ɒzdrʰɒpo
astyɡiton   ->    ɒzdʏɡudon͜n
aspʰalos   ->    ɒzpʰɒl̥oɬʷ
asyndɛtos   ->    ɒzyn͜ndɔdoɬʷ
asodes   ->    ɒzodoz
atallo   ->    ɒdɒn͜l̥lo
atastʰalos   ->    ɒdɒzdʰɒl̥oɬʷ
atrapʰaksys   ->    ɒdrʰɒpʰɒkzyz
apʰɛrɛo   ->    ɒpʰɔrɔo
apʰorizo   ->    ɒpʰoruzo
apʰrosyne   ->    ɒl̥̟̟̟̟ʰrʰoɬʷy̥n͜no
akʰates   ->    ɒkʰɒdoz
akʰlys   ->    ɒkʰlyz
akʰrios   ->    ɒkrʰuoɬʷ
apsintʰion   ->    ɒpzun͜ndʰuon͜n
habrodiɛtos   ->    hɒl̟̟̟̟rʰoduɔdoɬʷ
haɡnizmos   ->    hɒɡn͜nuzmoɬʷ
hadinos   ->    hɒdun͜noɬʷ
haliporpʰyros   ->    hɒl̥uporʰpʰʏroɬʷ
halmyros   ->    hɒl̥my̥roɬʷ
hamartani   ->    hɒm͜mɒrʰdɒn͜nu
aaptos   ->    ɒɒpdoɬʷ
abatos   ->    ɒbɒdoɬʷ
aɡamɛ   ->    ɒɡɒm͜mɔ
aɡrapʰos   ->    ɒɡrʰɒpʰoɬʷ
aɛtʰlon   ->    ɒɔdʰlon͜n
akantʰos   ->    ɒkɒn͜ndʰoɬʷ
akolos   ->    ɒko̥loɬʷ
akoros   ->    ɒko̥roɬʷ
akritʰos   ->    ɒkrʰudʰoɬʷ
alastos   ->    ɒl̥ɒzdoɬʷ
alɡema   ->    ɒn͜l̥ɡom͜mɒ
alipʰar   ->    ɒl̥upʰɒr
allos   ->    ɒn͜l̥loɬʷ
ambon   ->    ɒm͜mbon͜n
an   ->    ɒn͜n
anartʰros   ->    ɒn͜nɒrʰdʰrʰoɬʷ
anɛo   ->    ɒn͜nɔo
anodos   ->    ɒn͜nodoɬʷ
anotʰɛn   ->    ɒn͜nodʰɔn͜n
akson   ->    ɒkzon͜n
aplestos   ->    ɒplozdoɬʷ
arabos   ->    ɒrɒboɬʷ
arios   ->    ɒruoɬʷ
armɛnon   ->    ɒr̥ʰmɔn͜non͜n
ar̥r̥ostos   ->    ɒɽrʰdʰoɬʷdoɬʷ
arsen   ->    ɒrʰzon͜n
artos   ->    ɒrʰdoɬʷ
askios   ->    ɒzkuoɬʷ
askopos   ->    ɒzko̥poɬʷ
ate   ->    ɒdo
apʰtʰitos   ->    ɒpʰn͜dʰudoɬʷ
hamilla   ->    hɒm͜mullɒ
harma   ->    hɒrmɒ
atʰlon   ->    ɒdʰlon͜n
abia   ->    ɒbuɒ
aɡesilaos   ->    ɒɡozulɒoɬʷ
aɡrippine   ->    ɒɡrʰuppun͜no
adusios   ->    ɒdʊɬʷuoɬʷ
adryas   ->    ɒdrʰyɒz
aenobarbos   ->    ɒon͜nobɒrʰboɬʷ
atʰenesin   ->    ɒdʰon͜nozun͜n
atʰena   ->    ɒdʰon͜nɒ
aktɛon   ->    ɒkdɔon͜n
akylios   ->    ɒkʏluoɬʷ
alkamɛnes   ->    ɒl̥kɒm͜mɔn͜noz
alkmene   ->    ɒl̥kmon͜no
alyattes   ->    ɒn͜l̥yɒddoz
amazon   ->    ɒm͜mɒzon͜n
ampʰitʰoe   ->    ɒm͜mpʰudʰoo
anapʰe   ->    ɒn͜nɒpʰo
anaksimɛnes   ->    ɒn͜nɒkzum͜mʰɔn͜noz
andania   ->    ɒn͜ndɒn͜nuɒ
antinoos   ->    ɒn͜ndun͜nooɬʷ
antipas   ->    ɒn͜ndupɒz
antikytʰera   ->    ɒn͜ndukʏdʰorɒ
antron   ->    ɒn͜ndrʰon͜n
apaturia   ->    ɒpɒdʊ̜ruɒ
apidanos   ->    ɒpudɒn͜noɬʷ
apuleios   ->    ɒpʊlouoɬʷ
arizbe   ->    ɒruzbo
aramɛy   ->    ɒrɒm͜mɔy
arɡimpasa   ->    ɒrʰɡum͜mʰpɒzɒ
ariabiɡnes   ->    ɒruɒbuɡn͜noz
aristomakʰos   ->    ɒruzdomɒkʰoɬʷ
aristonymos   ->    ɒruzdon͜ny̥moɬʷ
artɛmision   ->    ɒr̥ʰdɔm͜muzuon͜n
arkʰɛlaos   ->    ɒr̥ʰkʰɔlɒoɬʷ
arkʰidamos   ->    ɒrʰkʰudɒm͜moɬʷ
asɛa   ->    ɒzɔɒ
assyria   ->    ɒzzy̥ruɒ
astɛrion   ->    ɒzdɔruon͜n
atlantis   ->    ɒdlɒn͜nduz
attikos   ->    ɒdduko̥ɬʷ
akʰaia   ->    ɒkɒuɒ
hatʰyr   ->    hɒdʰyrʰ
halikyɛ   ->    hɒl̥ukyɔ
aɡbalos   ->    ɒɡbɒl̥oɬʷ
alos   ->    ɒl̥oɬʷ
amasis   ->    ɒm͜mɒzuz
ammon   ->    ɒm͜mmon͜n
andros   ->    ɒn͜ndrʰoɬʷ
antipʰos   ->    ɒn͜ndupʰoɬʷ
arne   ->    ɒrʰn͜no
arpy   ->    ɒrʰpy
asios   ->    ɒzuoɬʷ
atropos   ->    ɒdrʰopoɬʷ
ɛŋɡytʰeke   ->    ɔŋ͜ŋɡʏdʰoko
ɛŋkratia   ->    ɔŋ͜ŋkrʰɒduɒ
ɛikostos   ->    ɔuko̥ɬʷdoɬʷ
ɛki   ->    ɔku
ɛkporewo   ->    ɔkporowo
ɛlatinos   ->    ɔlɒdun͜noɬʷ
ɛleʍtʰɛropsykʰos   ->    ɔloɺ̥̟̟̟̟ʰn͜dʰɔropzy̥kʰoɬʷ
ɛlɛos   ->    ɔlɔoɬʷ
ɛllos   ->    ɔlloɬʷ
ɛmmɛno   ->    ɔm͜mmɔn͜no
ɛmpyɛo   ->    ɔm͜mpʏɔo
ɛmpyrizmos   ->    ɔm͜mpʏruzmoɬʷ
ɛnantion   ->    ɔn͜nɒn͜nduon͜n
ɛndɛlɛkʰes   ->    ɔn͜ndɔlɔkʰoz
ɛndyno   ->    ɔn͜ndʏn͜no
ɛntʰadɛ   ->    ɔn͜ndʰɒdɔ
ɛntʰronios   ->    ɔn͜ndʰrʰon͜nuoɬʷ
ɛntɛllo   ->    ɔn͜ndɔllo
ɛntos   ->    ɔn͜ndoɬʷ
ɛnypnios   ->    ɔn͜nypn͜nuoɬʷ
ɛksapto   ->    ɔkzɒpdo
ɛksɛnarizo   ->    ɔkzɔn͜nɒruzo
ɛksomoloɡetikos   ->    ɔkzomoloɡoduko̥ɬʷ
ɛpaɡo   ->    ɔpɒɡo
ɛpimakʰos   ->    ɔpum͜mʰɒkʰoɬʷ
ɛpɛntitʰemi   ->    ɔpɒn͜ndudʰom͜mu
ɛpibɛno   ->    ɔpubɔn͜no
ɛpiɡlossis   ->    ɔpuɡloɬʷzuz
ɛpiikes   ->    ɔpuukoz
ɛpikalɛo   ->    ɔpukɒn͜l̥ɒo
ɛpikratɛo   ->    ɔpukrʰɒdɔo
ɛpimiks   ->    ɔpum͜mʰukz
ɛpir̥r̥ɛpo   ->    ɔpuɽrʷʰnʰɔpo
ɛpistɛllo   ->    ɔpuzdɔllo
ɛpitedewma   ->    ɔpudodowmɒ
ɛpipʰora   ->    ɔpupʰorɒ
ɛpokʰe   ->    ɔpokʰo
ɛponymon   ->    ɔpon͜ny̥mon͜n
ɛrɛtes   ->    ɔrɔdoz
ɛrɡaster   ->    ɔrʰɡɒzdorʰ
ɛrɛino   ->    ɔrɔun͜no
ɛrikydes   ->    ɔrukʏdoz
ɛryko   ->    ɔry̥ko̥
ɛromɛnos   ->    ɔromɔn͜noɬʷ
ɛremos   ->    ɔrom͜moɬʷ
ɛstʰio   ->    ɔzdʰuo
ɛskʰarion   ->    ɔzkʰɒruon͜n
ɛtosios   ->    ɔdoɬʷuoɬʷ
ɛpʰallomɛ   ->    ɔpʰɒn͜l̥lomɔ
ɛpʰewrisko   ->    ɔpʰowrʰuzko̥
ɛkʰinopus   ->    ɔkʰun͜nopuɬʷ
ɛyɛrɡes   ->    ɔyɔrʰɡoz
hɛbdomekontakɛɛkatontaplasion   ->    hɒbdomoko̥n͜ndɒkɒɔkɒdon͜ndɒplɒzuon͜n
hɛkkɛdɛkatos   ->    hɒkkɒdɔkɒdoɬʷ
hɛlɛdone   ->    hɒlɔdon͜no
hɛksekontamyros   ->    hɒkzoko̥n͜ndɒm͜my̥roɬʷ
hɛtɛra   ->    hɒdɔrɒ
hɛtɛralkes   ->    hɒdɔrɒl̥koz
hɛtɛronymos   ->    hɒdɔron͜ny̥moɬʷ
hɛtymos   ->    hɒdʏmoɬʷ
ɛpsilon   ->    ɔpzulon͜n
ɛbros   ->    ɔl̟̟̟̟rʰoɬʷ
ɛŋkawma   ->    ɔŋ͜ŋkɒwmɒ
ɛŋkʰɛlys   ->    ɔŋ͜ŋkʰɔlyz
ɛtʰo   ->    ɔdʰo
ɛɡɡonos   ->    ɔɡɡon͜noɬʷ
ɛkpaɡlos   ->    ɔkpɒɡloɬʷ
ɛktasis   ->    ɔkdɒzuz
ɛlɛon   ->    ɔlɔon͜n
ɛlymos   ->    ɔly̥moɬʷ
ɛmbryon   ->    ɔm͜ml̟̟̟̟rʰyon͜n
ɛmpiros   ->    ɔm͜mpuroɬʷ
ɛnstasis   ->    ɔn͜nzdɒzuz
ɛpitʰ   ->    ɔpudʰ
ɛpɛpʰnon   ->    ɔpɒpʰn͜non͜n
ɛripʰos   ->    ɔrupʰoɬʷ
ɛros   ->    ɔroɬʷ
ɛrysos   ->    ɔry̥zoɬʷ
hɛktos   ->    hɒkdoɬʷ
hɛo   ->    hɒo
hɛpomɛ   ->    hɒpomɔ
hɛspɛros   ->    hɒzpɒroɬʷ
ɛlɛpʰenor   ->    ɔlɔpʰon͜norʰ
ɛlpis   ->    ɔlpuz
ɛksɛnɛtos   ->    ɔkzɔn͜nɔdoɬʷ
ɛpidamnos   ->    ɔpudɒm͜mn͜noɬʷ
ɛratoklides   ->    ɔrɒdokludoz
ɛrytʰratʰalassa   ->    ɔrydʰrʰɒdʰɒl̥ɒzzɒ
ɛpʰialtes   ->    ɔpʰuɒn͜l̥doz
ɛpʰrɛm   ->    ɔl̥̟̟̟̟ʰrʰɔm͜m
ɛkʰɛmbrotos   ->    ɔkʰɔm͜ml̟̟̟̟rʰodoɬʷ
hɛkabe   ->    hɒkɒbo
hɛkate   ->    hɒkɒdo
elβiðios   ->    olvʷun̪͜ðuoɬʷ
hɛlkɛtʰion   ->    hɒlkɒdʰuon͜n
hɛrmoɡɛnes   ->    hɒrmoɡɔn͜noz
ɛdɛssa   ->    ɔdɔzzɒ
ɛnna   ->    ɔn͜nn͜nɒ
hɛlle   ->    hɒllo
eys   ->    oyz
eɡatʰɛos   ->    oɡɒdʰɔoɬʷ
etʰɛo   ->    odʰɔo
elyɡɛos   ->    oly̥ɡɔoɬʷ
epiolos   ->    opuoloɬʷ
heliazomɛ   ->    holuɒzomɔ
heliomantia   ->    holuomɒn͜nduɒ
hemɛra   ->    hom͜mɔrɒ
hemikrania   ->    hom͜mukrʰɒn͜nuɒ
hemitalanton   ->    hom͜mudɒl̥ɒn͜ndon͜n
hesykʰastes   ->    hozy̥kʰɒzdoz
etʰo   ->    odʰo
enystron   ->    on͜nyzdrʰon͜n
heros   ->    horoɬʷ
hedos   ->    hodoɬʷ
edonos   ->    odon͜noɬʷ
ekʰo   ->    okʰo
heɡesipyle   ->    hoɡozupʏlo
heraklɛotes   ->    horɒklɔodoz
herostratos   ->    horoɬʷdrʰɒdoɬʷ
iakʰo   ->    uɒkʰo
idɛa   ->    udɔɒ
idioma   ->    uduomɒ
ioides   ->    uoudoz
iskʰion   ->    uzkʰuon͜n
isopsepʰos   ->    uzopzopʰoɬʷ
ikʰtʰyao   ->    ukʰdʰʏɒo
hiɛraks   ->    huɔrɒkz
hidroo   ->    hudrʰoo
hiɛromyrtos   ->    huɔromyrʰdoɬʷ
hikɛtia   ->    hukɒduɒ
himation   ->    hum͜mʰɒduon͜n
hippoprosopos   ->    huppol̥̟̟̟̟rʰoɬʷopoɬʷ
hippodromos   ->    huppodrʰomoɬʷ
hippokremnos   ->    huppokrʰom͜mn͜noɬʷ
hippopʰlomos   ->    huppopʰlomoɬʷ
hiros   ->    huroɬʷ
historikos   ->    huzdoruko̥ɬʷ
iasis   ->    uɒzuz
iɡdis   ->    uɡduz
ikria   ->    ukrʰuɒ
ilarkʰos   ->    ulɒrʰkʰoɬʷ
induros   ->    un͜ndʊ̜roɬʷ
ikʰnos   ->    ukʰn͜noɬʷ
hiemi   ->    huom͜mu
hin   ->    hun͜n
iliŋks   ->    uluŋ͜ŋkz
ipos   ->    upoɬʷ
ialmɛnos   ->    uɒn͜l̥mɔn͜noɬʷ
iabɛzɛbytʰ   ->    uɒbɔzɔbydʰ
iaksamatɛ   ->    uɒkzɒm͜mɒdɔ
itʰometes   ->    udʰomodoz
illyrios   ->    ully̥ruoɬʷ
inopopʰylaks   ->    un͜nopopʰʏlɒkz
iudaikos   ->    uu̥dɒuko̥ɬʷ
iunios   ->    uu̥n͜nuoɬʷ
izmael   ->    uzmɒol
isondɛ   ->    uzon͜ndɔ
italos   ->    udɒl̥oɬʷ
ipʰiɡɛnia   ->    upʰuɡɔn͜nuɒ
ionopolis   ->    uon͜nopoluz
ioppi   ->    uoppu
hiɛrikʰo   ->    huɔrukʰo
hiɛropʰon   ->    huɔropʰon͜n
izburos   ->    uzbʊ̜roɬʷ
itylos   ->    udʏloɬʷ
obɛliskos   ->    obɔluzko̥ɬʷ
okris   ->    okrʰuz
oliɡarkʰikos   ->    oluɡɒrʰkʰuko̥ɬʷ
oliɡopsykʰɛo   ->    oluɡopzy̥kʰɔo
olopʰydnos   ->    olopʰydn͜noɬʷ
oniskos   ->    on͜nuzko̥ɬʷ
onidizo   ->    on͜nuduzo
onomastikon   ->    on͜nomɒzduko̥n͜n
oksya   ->    okzyɒ
oksyinos   ->    okzyun͜noɬʷ
opallios   ->    opɒn͜l̥luoɬʷ
optos   ->    opdoɬʷ
orɡizo   ->    orʰɡuzo
ortʰodoksia   ->    orʰdʰodokzuɒ
oropʰe   ->    oropʰo
orymaɡdos   ->    ory̥mɒɡdoɬʷ
orkʰɛomɛ   ->    orʰkʰɔomɔ
ostun   ->    oɬʷdun͜n
okʰtʰɛo   ->    okʰdʰɔo
opsotʰeke   ->    opzodʰoko
homyotropos   ->    homyodrʰopoɬʷ
horizon   ->    horuzon͜n
hormatʰos   ->    horʰmɒdʰoɬʷ
obryzon   ->    ol̟̟̟̟rʰy̥zon͜n
oɡmos   ->    oɡmoɬʷ
ollymi   ->    olly̥mu
ompʰaks   ->    ompʰɒkz
onyma   ->    on͜ny̥mɒ
opistʰɛn   ->    opuzdʰɔn͜n
orɛksis   ->    orɔkzuz
opʰɛlon   ->    opʰɔlon͜n
hotʰɛn   ->    hodʰɔn͜n
homilos   ->    homuloɬʷ
homoros   ->    homoroɬʷ
hoplon   ->    hoplon͜n
horasis   ->    horɒzuz
hosios   ->    hoɬʷuoɬʷ
hospɛr   ->    hoɬʷpɒr
hossos   ->    hoɬʷzoɬʷ
hotɛ   ->    hodɔ
hotti   ->    hoddu
odyseʍs   ->    odʏzoʍʰz
odomanty   ->    odomɒn͜ndy
oloosson   ->    olooɬʷzon͜n
olympios   ->    olympuoɬʷ
ombrike   ->    oml̟̟̟̟rʰuko
oksyr̥r̥yŋkʰos   ->    okzyɽrʷʰdʰyŋkʰoɬʷ
opus   ->    opuɬʷ
ornɛates   ->    orʰn͜nɔɒdoz
orytes   ->    ory̥doz
opʰrynion   ->    ol̥̟̟̟̟ʰrʰy̥n͜nuon͜n
hortesios   ->    horʰdozuoɬʷ
olbasa   ->    olbɒzɒ
hyɡropʰtʰoŋɡos   ->    hyɡrʰopʰn͜dʰoŋɡoɬʷ
hydrokɛpʰalon   ->    hydrʰokɒpʰɒl̥on͜n
hydroskopion   ->    hydrʰoɬʷko̥puon͜n
hypɛrpʰron   ->    hy̥pɒrl̥̟̟̟̟ʰrʰon͜n
hypallasso   ->    hy̥pɒn͜l̥lɒzzo
hypɛrnɛpʰɛlos   ->    hy̥pɒrn͜nɔpʰɔloɬʷ
hyperɛsia   ->    hy̥porɔzuɒ
hypoklɛpto   ->    hy̥poklɔpdo
hypomɛno   ->    hy̥pomɔn͜no
hypostates   ->    hy̥poɬʷdɒdoz
hypotɛlɛo   ->    hy̥podɔlɔo
hypobatʰron   ->    hy̥pobɒdʰrʰon͜n
hypodema   ->    hy̥podom͜mɒ
hystɛrema   ->    hyzdɔrom͜mɒ
hypʰeɡesis   ->    hy̥pʰoɡozuz
hypsotʰɛn   ->    hypzodʰɔn͜n
hyopʰtʰalmos   ->    hyopʰn͜dʰɒn͜l̥moɬʷ
ymmɛs   ->    ymmɔz
hyalos   ->    hyɒl̥oɬʷ
hypatos   ->    hy̥pɒdoɬʷ
hyraks   ->    hy̥rɒkz
hypsi   ->    hypzu
hys   ->    hyz
hymɛs   ->    hy̥mɔz
hypɛrbɛrɛtɛos   ->    hy̥pɒrbɔrɔdɔoɬʷ
hypɛresie   ->    hy̥pɒrozuo
hyble   ->    hyblo
hydissa   ->    hy̥duzzɒ
hyssos   ->    hyzzoɬʷ
okimoidɛs   ->    okum͜mʰoudɔz
omotribes   ->    omodrʰuboz
opʰɛlɛo   ->    opʰɔlɔo
o   ->    o
ora   ->    orɒ
orion   ->    oruon͜n
ostia   ->    oɬʷduɒ
ode   ->    odo
r̥azma   ->    rʰɒzmɒ
r̥ammatinos   ->    rʰɒm͜mmɒdun͜noɬʷ
r̥apʰidotʰeke   ->    rʰɒpʰudodʰoko
r̥itʰron   ->    rʰudʰrʰon͜n
r̥etorikos   ->    rʰodoruko̥ɬʷ
r̥inotoros   ->    rʰun͜nodoroɬʷ
r̥iskopʰylaks   ->    rʰuzko̥pʰʏlɒkz
r̥omboides   ->    rʰomboudoz
r̥ytʰmos   ->    rʰydʰmoɬʷ
r̥yparopʰaɡos   ->    rʰy̥pɒropʰɒɡoɬʷ
r̥ytis   ->    rʰy̥duz
r̥okʰmos   ->    rʰokʰmoɬʷ
r̥ome   ->    rʰomo
r̥atʰymos   ->    rʰɒdʰʏmoɬʷ
r̥abɛnna   ->    rʰɒbɔn͜nn͜nɒ
r̥ɛa   ->    rʰɔɒ
r̥ebas   ->    rʰobɒz
r̥enia   ->    rʰon͜nuɒ
r̥izus   ->    rʰuzuɬʷ
r̥uben   ->    rʰu̥bon͜n
r̥ode   ->    rʰodo


CHANGED WORDS ; 

ɒkuz  ;  ɔn͜nɒ  ;  uz  ;  dɒdoɬʷ  ;  oɬʷ  ;  ɔɡɔ  ;  ɔɡuzdʰoɬʷ  ;  ɔdʰɒl̥oɬʷ  ;  ɔoloɬʷ  ;  ɒwɡuɒz  ;  ɒwluz  ;  ɒʍʰdon͜noo  ;  ɒʍʰkzu̥mon͜n  ;  bɒɒl̥  ;  bɒn͜l̥bʊ̜̥rɒ  ;  bɔrʰɡɒ  ;  bɒkdrʰuɒ  ;  bodrʰuɒko̥n͜n  ;  byodoɬʷ  ;  bodduɔy  ;  bʊduon͜n  ;  l̟̟̟̟rʰɔn͜nɔ  ;  l̟̟̟̟rʰɒwrʰon͜n  ;  l̟̟̟̟rʰoʍʰky  ;  l̟̟̟̟rʰykluko  ;  byzn͜nɔy  ;  bolko̥n͜n  ;  boɬʷporoɬʷ  ;  ɡɒl̟̟̟̟rʰuol  ;  ɡɒdʰɔɔ  ;  ɡɔn͜nn͜nozɒrɔd  ;  ɡɔron͜nuoɬʷ  ;  ɡoryon͜nɒz  ;  ɡolɡodʰɒ  ;  ɡorʰɡuɒz  ;  ɡorullɔ  ;  dɒpʰn͜no  ;  dupɒɒ  ;  durʰpʰyz  ;  dɒdɒkoz  ;  dɒm͜mɒzko̥ɬʷ  ;  ðɒn͜nɒvʷu  ;  dun͜nolokʰoɬʷ  ;  doʍʰz  ;  dom͜mɒrɒdoɬʷ  ;  dom͜mokludoz  ;  dom͜mopʰuloɬʷ  ;  doru̥ɬʷuɔy  ;  duon͜ny̥zuoɬʷ  ;  duoɬʷku̥roɬʷ  ;  domuduoɬʷ  ;  drʰulon͜n  ;  dorum͜mʰɒkʰoɬʷ  ;  uludʰyɒ  ;  oʍʰn͜dʰʏmɔn͜noz  ;  oʍʰkloz  ;  owrʰykloz  ;  owrʰopɒ  ;  oʍʰkʰon͜norʰ  ;  owmɔoɬʷ  ;  zɒŋ͜ŋ̊klo  ;  zɒn͜n  ;  zbɔldʰuurʰdoɬʷ  ;  zɔlpʰɒ  ;  zokɒz  ;  zon͜nobuoɬʷ  ;  dʰɒry̥buz  ;  dʰɒpzɒko̥ɬʷ  ;  dʰɔm͜muz  ;  dʰɔoɡn͜nuz  ;  dʰɔrʰmo  ;  dʰuzbo  ;  dʰɔzl̥̟̟̟̟rʰodoɬʷ  ;  dʰɔol̥̟̟̟̟ʰrʰɒzdoɬʷ  ;  dʰorɒm͜mɔn͜noz  ;  dʰʊkʏdudoz  ;  dʰrʰɒkz  ;  dʰrʰokz  ;  kɒbury  ;  kɒn͜lʰkʰɒz  ;  kɒm͜muroɬʷ  ;  kɒn͜ndɒl̟̟̟̟rʰy  ;  kɒrbon͜n  ;  kɒruɬʷzɒ  ;  kɒrpuz  ;  kɒzdɒboɬʷ  ;  kɒdon͜n  ;  kɒun͜n  ;  kɒrkʏrɒ  ;  korʰ  ;  kurʰko  ;  kɒdmouz  ;  kɒn͜lʰpurʰn͜nuoɬʷ  ;  kɒn͜ndɒko  ;  kɒzzɒn͜ndrʰɒ  ;  kɒuɒpʰɒz  ;  kɒŋ͜ŋkʰrʰɔɔ  ;  kopʰuzoɬʷ  ;  kum͜mʰmɔruoɬʷ  ;  klɔɒn͜norʰ  ;  klɔopʰon͜n  ;  klɔoml̟̟̟̟rʰodoɬʷ  ;  kloduoɬʷ  ;  ko̥pdoɬʷ  ;  ko̥rʰdʏbo  ;  ku̥dodoɬʷ  ;  krʰudobʊloɬʷ  ;  krʰoɬʷzɔo  ;  kʏdɒn͜ndudɔ  ;  kʏdon͜nuɒ  ;  ko̥ddɒz  ;  kyɽrʷʰdʰoɬʷ  ;  ko̥ɬʷ  ;  lɒdon͜n  ;  lɒkmon͜n  ;  lɒruzɒ  ;  lɔbɔdoɬʷ  ;  luzzoɬʷ  ;  lɒm͜mpzɒkon͜noɬʷ  ;  lɒzɔɒ  ;  lɔkzupʰɒn͜noz  ;  lɔdrʰun͜ny  ;  loʍʰkɒn͜noɬʷ  ;  loʍʰko̥dʰɔɒ  ;  lɔon͜nudoz  ;  lubyrʰn͜noɬʷ  ;  lukun͜nn͜nuɒ  ;  lum͜mʰon͜nɒrʰɡooɬʷ  ;  lu̥ɬʷuoɬʷ  ;  ly̥kuo  ;  ly̥kɒboddoɬʷ  ;  lyzdrʰɒ  ;  mɒɡdoloɬʷ  ;  mɒdʏdoɬʷ  ;  mɒn͜l̥luoɬʷ  ;  mɒruɒ  ;  mɒruon͜n  ;  mɔlodoɬʷ  ;  mɔm͜mn͜non͜n  ;  mɒɡn͜nozuɒ  ;  mɒkɒruɒ  ;  mɒn͜l̥ɒo  ;  mɒn͜nɒzzoz  ;  mɒn͜ndun͜noʍʰz  ;  mɒrɒkɒn͜ndɒ  ;  mɒrʰmɒruon͜n  ;  mɒzzɒn͜l̥uɒ  ;  mɒkʰɒn͜nudɒz  ;  mɔɡɒl̥ohɒllɒz  ;  mɔludo  ;  mɔropo  ;  mɔzzon͜no  ;  mɔdɒpon͜nduoɬʷ  ;  moluoʍʰz  ;  mun͜ndurʰn͜no  ;  mn͜noʍuz  ;  morʰpʰoʍʰz  ;  mu̥n͜ny̥kʰuon͜n  ;  my̥zuɒ  ;  my̥rɒ  ;  n͜nɒɡudoɬʷ  ;  n͜nɒpɒruz  ;  n͜nɒrʰn͜nuɒ  ;  n͜nɔɒrʰkʰoɬʷ  ;  n͜nɔm͜mɔzuz  ;  n͜nɔpoɬʷ  ;  n͜nukɒrkʰoɬʷ  ;  n͜nɒʍʰkrʰɒduz  ;  n͜noloʍʰz  ;  n͜nuko̥lɒoɬʷ  ;  n͜nomɒn͜ndun͜noɬʷ  ;  n͜nu̥mɔruoɬʷ  ;  n͜nuzoɬʷ  ;  kzouz  ;  y̥dupuɬʷ  ;  ykludoz  ;  y̥n͜nuɒdɔ  ;  yɒɡrʰoɬʷ  ;  uun͜ndukz  ;  uɒroɬʷ  ;  pɒko̥roɬʷ  ;  pɒn͜nom͜moɬʷ  ;  pɒn͜norʰmoɬʷ  ;  pɒrmyz  ;  pɒllɒ  ;  pɒrɡo  ;  polokɒz  ;  puɔrɔz  ;  pɒdɔy  ;  pɒl̥ɒzdun͜no  ;  pɒl̥uz  ;  pɒn͜l̥lon͜no  ;  pɒn͜nɒdʰon͜nɒuko̥ɬʷ  ;  pɒrɒzkowo  ;  pɒrdʰuɒ  ;  pɒzukloz  ;  pɒpʰlɒɡon͜nuɒ  ;  pɒkʰon͜n  ;  purudʰuɬʷ  ;  purɒoʍʰz  ;  pɒlɒzɡuko̥ɬʷ  ;  pɒlopon͜nn͜nozuoɬʷ  ;  pɒruklœ̞mɔn͜noɬʷ  ;  pɒrdun͜nɒkz  ;  pukon͜noɬʷ  ;  pudɒn͜no  ;  pn͜nowmɒdohɒɡuon͜n  ;  polykzo  ;  poly̥doroɬʷ  ;  porʰpʰʏruon͜n  ;  podudɔɒ  ;  l̥̟̟̟̟rʰokzɒzpoz  ;  l̥̟̟̟̟rʰoko̥n͜nn͜nozoɬʷ  ;  l̥̟̟̟̟rʰy̥doɬʷ  ;  pʏdʰɒɡoruko̥ɬʷ  ;  pon͜ndoɬʷ  ;  pʏloɬʷ  ;  zɒrʰduz  ;  zorʰ  ;  zɔl̥̟̟̟̟rʰoɬʷ  ;  zɒn͜l̥ɡɒn͜noʍʰz  ;  zɒl̥on͜nuoɬʷ  ;  zɒm͜moɬʷɒdɒ  ;  zɒrɒŋ͜ŋɡɔ  ;  zɒdɒn͜n  ;  zɔloʍʰkudoz  ;  zɔlun͜nuɬʷ  ;  zoku̥ɒn͜noɬʷ  ;  zdʰɔn͜no  ;  zun͜ndoɬʷ  ;  zurɒkon͜ny  ;  zkudrʰoɬʷ  ;  zkʏlɒko  ;  zmulɒ  ;  zmyrʰn͜nɒ  ;  zoluɬʷ  ;  zu̥dɒ  ;  zdrʰombukʰudoz  ;  zdyllɒŋ͜ŋɡuon͜n  ;  zdykz  ;  zy̥rɒku̥ɬʷɒ  ;  zoɬʷuɡɔn͜noz  ;  zozu̥ɬʷɒ  ;  zozdoɬʷ  ;  zun͜nɔ  ;  zy̥roɬʷ  ;  dɒn͜nɒɡrʰɒ  ;  dɒrʰdɒroɬʷ  ;  dɔm͜mpo  ;  dolɔpʰoɬʷ  ;  duron͜n  ;  dɒn͜l̥dʰʏbuoɬʷ  ;  dɒrʰkʏn͜nuoɬʷ  ;  dɔlɒm͜mon͜n  ;  dɔlmozzoɬʷ  ;  dɔrʰpzukʰorɒ  ;  doruo  ;  dudʰrʰon͜nuon͜n  ;  dum͜mʰodʰɔoɬʷ  ;  dudɒn͜nuz  ;  duɬʷklɒn͜noɬʷ  ;  drʰɒpɒzuɬʷ  ;  drʰɒuɒn͜noɬʷ  ;  drʰoɡuloɬʷ  ;  drʰooɬʷ  ;  dyn͜ndɒrɔoɬʷ  ;  dʏrɒm͜mbɔ  ;  pʰɒrbɔdʰoɬʷ  ;  pʰɒl̟̟̟̟rʰukuoɬʷ  ;  pʰɔdrʰuɒ  ;  pʰɔzdoɬʷ  ;  pʰɒrn͜nɒbɒzoɬʷ  ;  pʰɔrɔ  ;  pʰulɒudɔ  ;  pʰlɔɡyɒz  ;  pʰluuɬʷ  ;  pʰʏn͜nuko  ;  l̥̟̟̟̟ʰrʰɔɡɔllɒ  ;  l̥̟̟̟̟ʰrʰy̥ɡuɒ  ;  pʰʏlo  ;  pʰʏduɒ  ;  pʰorʰko̥ɬʷ  ;  pʰolukz  ;  kʰɒon͜n  ;  kʰɒl̟̟̟̟rʰuɒz  ;  kʰɔron͜nuɒ  ;  kʰɒl̥ɒzdrʰɒ  ;  kʰɒn͜nɒɒn͜n  ;  kʰɒrudom͜moɬʷ  ;  kʰrʰy̥zuz  ;  kʰrʰomuoɬʷ  ;  kʰorʰzoɬʷ  ;  pzozzuy  ;  pzɒm͜mmodukʰoɬʷ  ;  pzy̥ruo  ;  ɔɡuɒl̥opʰʏlɒkz  ;  ɔdɔomɔ  ;  ɔdo  ;  ɔzkʰʏn͜no  ;  ɔduzo  ;  hɒrɔzuodoz  ;  ɔdʰ  ;  ɔdʰʊɬʷɒ  ;  ɔlu̥roɬʷ  ;  ɔn͜ny̥mɔ  ;  ɔzdʰozuz  ;  ɔpzɒ  ;  ɒʍʰdoɔpudʰʏmuɒ  ;  ɒʍʰdokʰdʰon͜n  ;  ɒʍʰdʰ  ;  ɒʍʰd  ;  bɒduoɬʷ  ;  bɒn͜l̥lo  ;  bɒrʰbɒkz  ;  bɔboloɬʷ  ;  bokz  ;  bɔn͜no  ;  bɒdʰʏko̥lʰpoɬʷ  ;  bɒl̥ɒn͜nuon͜n  ;  bɒpduzmoɬʷ  ;  bɒryz  ;  bɒzulowo  ;  bɒzzɒrɒ  ;  bɒduɒko  ;  vʷɒddoloxʷuɒ  ;  bdɔlluon͜n  ;  bɔlon͜no  ;  bubluodʰoko  ;  buzɒkuon͜n  ;  buoɬʷ  ;  blɔpo  ;  blɒbɔroɬʷ  ;  blɒzdoɬʷ  ;  bluzdoruz  ;  blomoɬʷ  ;  boodʰuɒ  ;  borʰboryɡmoɬʷ  ;  bʊko̥ry̥zɒ  ;  buɬʷdrʰopʰodon͜n  ;  bʊlomɔ  ;  bul̥̟̟̟̟rʰozduz  ;  bʊdʏron͜n  ;  l̟̟̟̟rʰɒŋ͜ŋkʰoɬʷ  ;  l̟̟̟̟rʰum͜mʰo  ;  l̟̟̟̟rʰodoly̥ɡoɬʷ  ;  l̟̟̟̟rʰy̥kʰom͜mɒ  ;  bybluon͜n  ;  bʏdʰoɬʷ  ;  boludoz  ;  bɒruz  ;  bo  ;  ɡɒl̥ɒz  ;  ɡɒl̥oɬʷ  ;  ɡuŋ͜ŋɡrʰoɬʷ  ;  ɡɔon͜n  ;  ɡɒl̥on͜noɬʷ  ;  ɡɒm͜mpzon͜nykz  ;  ɡɒzdorʰ  ;  ɡɒʍʰzoɬʷ  ;  ɡudon͜n  ;  ɡɔlyoɬʷ  ;  ɡɔn͜nɔdorʰ  ;  ɡɔn͜nɔdʰluɒko̥ɬʷ  ;  ɡɔrɒn͜nuon͜n  ;  ɡɔɽrʷʰdʰokʰɔlon͜no  ;  ɡlɒm͜moɬʷ  ;  ɡlɒʍʰko̥puz  ;  ɡly̥kyz  ;  ɡloɬʷzuz  ;  ɡlun͜noɬʷ  ;  ɡn͜nodɔrɒ  ;  ɡn͜noɬʷduko̥ɬʷ  ;  ɡon͜noz  ;  ɡrʰɒbuon͜n  ;  ɡrʰɒo  ;  ɡrʰɒm͜mmo  ;  ɡrʰykz  ;  ɡʏluoɬʷ  ;  ɡʏn͜nɔko̥n͜nuduz  ;  ɡypzun͜noɬʷ  ;  dɔ  ;  dɔkɒdoɬʷ  ;  dɔlpʰɒkz  ;  dɔon͜n  ;  dɔrʰko̥mɔ  ;  dɔro  ;  dɔdrʰoɬʷy̥n͜no  ;  dɒkdœ̞luodʰoko  ;  dɒn͜nuzdoz  ;  dɒr̥ʰdɔn͜nu  ;  dɒzuɒ  ;  dɒdɔomɔ  ;  dukduko̥ɬʷ  ;  duro  ;  dɔn͜ndullo  ;  dolodorʰ  ;  dom͜mopudʰoko̥ɬʷ  ;  duɒboloɬʷ  ;  duɒzomɒ  ;  duɒl̥um͜mʰmɒ  ;  duɒzdɒzuz  ;  duɒko̥n͜nɔo  ;  duɒn͜l̥yo  ;  duɒn͜nyo  ;  duɒɽ̊r̥ʰdʰɔo  ;  duɒpʰɒn͜noz  ;  duɒkʰoruzo  ;  dudʰʏrɒm͜mbuko̥ɬʷ  ;  dukɒoɬʷy̥n͜no  ;  dukdɒm͜mn͜nun͜noɬʷ  ;  dun͜nouz  ;  duy̥ko̥domɔo  ;  dupzoroɬʷ  ;  doɒzzɒdo  ;  dokɒo  ;  dolukʰoɬʷ  ;  dokzɒzo  ;  dorʰkɒz  ;  doduko̥ɬʷ  ;  dʊpɒo  ;  drʰɒɡmɒ  ;  drʰɒko̥n͜nduoɬʷ  ;  drʰɒzduko̥ɬʷ  ;  drʰopuz  ;  drʰyopz  ;  dyokɒdɔkɒ  ;  dyzkɒlɒdoɬʷ  ;  dyzdʏkʰuɒ  ;  doɡmɒ  ;  domɒ  ;  udoduko̥ɬʷ  ;  uk  ;  uron͜nɒrʰkʰoz  ;  uzɔrʰkʰomɔ  ;  hum͜mʰɒdɒn͜nopɒrubɒn͜l̥loɬʷ  ;  uko̥ɬʷu  ;  huoɬʷ  ;  owɔ  ;  owdɔm͜mon͜n  ;  oʍʰpɒdoʍʰzuɒ  ;  owrʰy̥pɒduloɬʷ  ;  owrʰon͜nodoɬʷ  ;  oʍʰl̥̟̟̟̟ʰrʰon͜nɔon͜n  ;  oʍʰporoɬʷ  ;  oɺ̥̟̟̟̟ʰzɔlmoɬʷ  ;  own͜nuz  ;  oɺ̥̟̟̟̟ʰdɔ  ;  zuŋ͜ŋ̊ɡoɬʷ  ;  zowɡn͜ny̥mu  ;  zoɡɒn͜noz  ;  zy̥ɡun͜noɬʷ  ;  zon͜nn͜ny̥mu  ;  zoduon͜n  ;  dʰɒl̥pzuz  ;  dʰɔzuz  ;  dʰɔdoz  ;  dʰɒl̥ɒzzɔɡlo  ;  dʰɒl̥ɒroɬʷ  ;  dʰɒn͜nɒdopʰoroɬʷ  ;  dʰɔɒdrʰokrʰɒduɒ  ;  dʰɔoloɡoɬʷ  ;  dʰɔol̥̟̟̟̟rʰopɒo  ;  dʰɔoroɬʷ  ;  dʰuoɬʷ  ;  dʰoruodoz  ;  dʰolɔroɬʷ  ;  dʰrʰudɒkz  ;  dʰrʰɒwmɒ  ;  dʰrʰon͜non͜n  ;  dʰʏroroɬʷ  ;  dʰʏmɒrʰn͜non͜n  ;  dʰʏmon͜n  ;  dʰʏrɒzɔ  ;  dʰyo  ;  dʰorokz  ;  dʰolyz  ;  dʰubuz  ;  kɒm͜mmɒroɬʷ  ;  kɒm͜mpzɒ  ;  kɒpɒdoɬʷ  ;  kɒron͜non͜n  ;  kɒrdoɬʷ  ;  kɒrpʰoɬʷ  ;  kɒdɒ  ;  kɒloz  ;  kɒm͜mmorʰ  ;  kɒrdʰuoɬʷ  ;  kɒrkʰn͜no  ;  kuŋ͜ŋkloɬʷ  ;  kuzurʰn͜nuz  ;  kɒruoɬʷ  ;  kɒdʰ  ;  kɒdʰuzdom͜mu  ;  kɒdʰɒrʰduko̥ɬʷ  ;  kɒkkɒbo  ;  kɒko̥my̥roɬʷ  ;  kɒko̥ɬʷ  ;  kɒl̥ɒm͜modʰoko  ;  kɒn͜l̥uɒ  ;  kɒn͜l̥ludʰrʰukz  ;  kɒn͜l̥lupɒdɒl̥on͜n  ;  kɒn͜ndʰuɔ  ;  kɒrkun͜noɬʷ  ;  kɒzuɒ  ;  kɒdɒɡn͜ny̥mu  ;  kɒdɒzdɔɡoɬʷ  ;  kɒdɔpɒpʰn͜non͜n  ;  kɒdɒl̥ɒɡo  ;  kɒdɒn͜nɒŋ͜ŋko  ;  kɒdɒl̥̟̟̟̟rʰɒkduko̥n͜n  ;  kɒdɒl̥̟̟̟̟ʰrʰon͜noduko̥ɬʷ  ;  kɒdɔdykz  ;  kɒdokʰodoz  ;  kɒdopuzdʰɔn͜n  ;  kɒʍʰzuɒ  ;  kɒkʰɔkdoz  ;  kɒdrʰudoz  ;  kɒlɔn͜noɬʷ  ;  kɒn͜ndɔo  ;  kɒrɒm͜muz  ;  kɒrɒdɔɒ  ;  koʍʰn͜dʰo  ;  kuz  ;  kory̥loɬʷ  ;  kukʏmuz  ;  kun͜nɔo  ;  kun͜ny̥rɒ  ;  klɒdun͜noɬʷ  ;  klodʰrʰun͜noɬʷ  ;  kludoruz  ;  klodoɬʷ  ;  kluzuo  ;  kly̥don͜n  ;  kn͜nupz  ;  kn͜noko̥ɬʷ  ;  kʏlomɒ  ;  ko̥kko̥dʰrʰɒʍʰzdoz  ;  ko̥lɔopdɔroɬʷ  ;  ko̥lymbɒz  ;  ko̥lobuon͜n  ;  ko̥moon͜n  ;  ko̥n͜nuo  ;  ko̥pɒduon͜n  ;  ko̥ruɒn͜nn͜non͜n  ;  ko̥ron͜no  ;  ko̥zmopoludɒz  ;  ku̥ruz  ;  kyoɬʷ  ;  krʰɔm͜mbɒl̥ɒ  ;  krʰoɡyoɬʷ  ;  krʰudʰun͜noɬʷ  ;  krʰun͜non͜n  ;  krʰɔpn͜noɬʷ  ;  krʰɒn͜nuon͜n  ;  krʰɒdɔron͜nykz  ;  krʰɒdyz  ;  krʰozɔrɒ  ;  krʰoko̥mɒɡmɒ  ;  krʰɔ̞pɒzɔ  ;  krʰœ̞pʰɒ  ;  kdɒomɔ  ;  kduzuz  ;  kdon͜noɬʷ  ;  kyɒn͜nopdɔroɬʷ  ;  kʏbɔrʰn͜noduko̥ɬʷ  ;  kʏkɒon͜n  ;  kʏmun͜nodʰoko  ;  kʏn͜nuduon͜n  ;  kʏn͜nokrʰɒm͜mbo  ;  kʏn͜nokkʰɒn͜lʰko  ;  kyl̥̟̟̟̟rʰun͜noɬʷ  ;  ko̥buoɬʷ  ;  ko̥kyo  ;  ko̥ŋɡuon͜n  ;  ko̥loɬʷ  ;  ko̥roɬʷ  ;  ko̥rymboɬʷ  ;  ko̥pzɒ  ;  kykn͜noɬʷ  ;  kʏrudʰrʰɒ  ;  kʏmɒ  ;  kʏpʰu  ;  ko̥mɒ  ;  lɒl̟̟̟̟rʰyz  ;  lɒm͜mbdɒ  ;  lɒpɒdʰoɬʷ  ;  lɒun͜noɬʷ  ;  luon͜n  ;  lun͜non͜n  ;  lɒŋ͜ŋkuɒ  ;  lɒdʰrʰɔoɬʷ  ;  lɒn͜l̥ɒo  ;  lɒkʰɒn͜nodʰoko  ;  lɒwrʰɒ  ;  lɔpʰoɬʷ  ;  lubo  ;  ludurʰɡuɒ  ;  lɔkduko̥ɬʷ  ;  lɔpdoɡɔoɬʷ  ;  lowrʰoɬʷ  ;  lubɒn͜nodʰoko  ;  loɡomɒkʰuɒ  ;  ly̥poɬʷ  ;  lorʰdoɬʷ  ;  lyɡrʰoɬʷ  ;  ly̥ko̥ɬʷko̥rʰdon͜n  ;  lyl̥̟̟̟̟rʰoɬʷ  ;  ly̥zum͜mʰɒkʰuon͜n  ;  lorymn͜non͜n  ;  lokʰoɬʷ  ;  lobo  ;  lozduɒ  ;  lozomɔ  ;  mɒkurʰ  ;  mɒzdukz  ;  mɔɡɒron͜n  ;  mɔdomɔ  ;  mɔdʰodoɬʷ  ;  mɔlɒn͜n  ;  mɔlpo  ;  mɔn͜no  ;  mɔdrʰuoɬʷ  ;  mozdorʰ  ;  mudɒz  ;  mukzuz  ;  mɒdʰodowo  ;  mɒn͜nuɒ  ;  mɒzɒomɔ  ;  mɒdɔodɔkn͜nuɒ  ;  mɒpzuduoɬʷ  ;  muluɡmɒ  ;  mɔlɒn͜nu̥roɬʷ  ;  mɔlum͜mʰolon͜n  ;  mɔlɒŋ͜ŋko̥ry̥pʰoɬʷ  ;  mɔn͜nɔɔn͜no  ;  mɔn͜noukoz  ;  mɔzolɒboɬʷ  ;  mɔdɒbɒn͜l̥lo  ;  mɔdɒn͜nɒzdɒzuz  ;  mɔdɒpʰon͜nɔo  ;  mɔdʏkuɒ  ;  modɒm͜moɬʷ  ;  molodrʰuz  ;  mon͜noudoz  ;  mokʰɒn͜nɒomɔ  ;  mukrʰoloɡuɒ  ;  mum͜mʰɔomɔ  ;  muzdyllo  ;  mn͜nozupom͜mon͜n  ;  molɡoɬʷ  ;  molybdɔn͜nɒ  ;  mon͜no  ;  mon͜nɒr̥ʰkʰɔo  ;  my̥ɡɒn͜l̥ɒo  ;  my̥dʰodoz  ;  my̥kodun͜noɬʷ  ;  owopʰn͜dʰɒn͜l̥moɬʷ  ;  my̥robɒl̥ɒn͜nun͜noɬʷ  ;  myrʰzun͜nudoz  ;  mon͜nopz  ;  moron͜n  ;  moɬʷkʰun͜noɬʷ  ;  mokʰdʰoɬʷ  ;  mylloɬʷ  ;  myzduz  ;  myopz  ;  moruoɬʷ  ;  modoɬʷ  ;  n͜nɒrʰdʰokz  ;  n͜nɒpʰn͜dʰɒ  ;  n͜nɔomɔ  ;  n͜no  ;  n͜nopuoɬʷ  ;  n͜nun͜non͜n  ;  n͜nɔ  ;  n͜nɒʍʰz  ;  n͜nɔkrʰo  ;  n͜nɔkʏdɒn͜l̥loɬʷ  ;  n͜nowrʰɒ  ;  n͜nɔpʰɔloɡɔrɔdɒ  ;  n͜nuko̥ɬʷ  ;  n͜nozuodoz  ;  n͜noɔo  ;  n͜nomodʰɔduko̥ɬʷ  ;  n͜noɬʷoroɬʷ  ;  n͜ny̥dʰoɬʷ  ;  n͜nympʰolopdoɬʷ  ;  n͜nyzdɒɡmoɬʷ  ;  n͜nodun͜noɬʷ  ;  n͜nodon͜n  ;  n͜nou  ;  kzɔn͜noɬʷ  ;  kzɒn͜ndʰoloʍʰko̥ɬʷ  ;  kzɔn͜nuɒ  ;  kzon͜noɬʷ  ;  kzœ̞lɒn͜l̥oo  ;  kzymplɔo  ;  kzœ̞n͜nudoɬʷ  ;  kzy̥n͜noɬʷ  ;  kzy̥lon͜n  ;  kzyo  ;  y̥ko̥n͜nomoɬʷ  ;  y̥n͜nokʰoo  ;  y̥zyun͜noɬʷ  ;  y̥kʰomɔn͜noɬʷ  ;  y̥kozuz  ;  y̥my  ;  hyoɬʷ  ;  u̥dɔdɔroɬʷ  ;  u̥lɔ  ;  u̥rɔo  ;  u̥rɒn͜nuzko̥ɬʷ  ;  u̥duz  ;  hu̥n͜nɔkɒ  ;  uɬʷ  ;  pɒn͜ndoɬʷɒ  ;  pɒl̥̟̟̟̟rʰɒkz  ;  pɒry̥ko̥ɬʷ  ;  pɒzuz  ;  pɒlɔkyz  ;  pɒm͜mpʰukz  ;  pɒdrʰun͜noɬʷ  ;  pɒpzuz  ;  poɡn͜ny̥mu  ;  poro  ;  pum͜mʰplom͜mu  ;  pun͜nun͜noɬʷ  ;  puon͜n  ;  pɒzo  ;  pɒduon͜n  ;  pɒdɒɡoɡuɒ  ;  pɒl̥uu̥run͜noɬʷ  ;  pɒm͜mmɔɡɔdʰoz  ;  pɒn͜ndɒkʰu  ;  pɒrɒkʏduz  ;  pɒrɒl̥̟̟̟̟ʰrʰɒzuz  ;  pɒrɔrʰkʰomɔ  ;  pɒrɔ  ;  pɒrɒbolɒn͜ny  ;  pɒrɒduɡmɒduko̥ɬʷ  ;  pɒrɒn͜l̥loloɡrʰɒm͜mmoɬʷ  ;  pɒrɒn͜nomuɒ  ;  pɒruɒz  ;  pɒɽrʰdʰozuɒ  ;  pɒzdoɬʷ  ;  pɒdɔomɔ  ;  pɒdrʰuɒ  ;  pɒwlɒ  ;  pɒloruz  ;  pɒn͜ndɒkuzkʰuluy  ;  pɒn͜ndoko̥ɬʷdo  ;  pɒr  ;  pɒruzomɒ  ;  pɒrubɒn͜l̥lo  ;  pɒruporʰpʰʏroɬʷ  ;  pɒruzdrʰopʰuz  ;  pɒrudyŋkʰɒn͜no  ;  pɒrkn͜noɬʷ  ;  pɒrzɔɒ  ;  pɒdun͜noɬʷ  ;  puzmɒ  ;  podoɬʷ  ;  puzɡuz  ;  plɒdʰɒn͜non͜n  ;  plɒzuz  ;  plɔɡmɒ  ;  plom͜mn͜no  ;  plozmuoɬʷ  ;  plɒdɒn͜nuzdun͜noɬʷ  ;  plɔkdɒn͜no  ;  ploko  ;  plu̥doɬʷ  ;  ploɡmɒ  ;  pn͜noo  ;  podon͜nɔm͜moɬʷ  ;  pyodoz  ;  pʏn͜no  ;  polɔm͜muoɬʷ  ;  poluoɬʷ  ;  pollɒku  ;  poly̥mɒdʰoz  ;  polyzdɒpʰʏloɬʷ  ;  poly̥ɡɒl̥on͜n  ;  polypʰlyzboɬʷ  ;  pompoɬʷ  ;  porowo  ;  l̥̟̟̟̟rʰɔm͜mn͜non͜n  ;  l̥̟̟̟̟rʰɒɡmɒduko̥ɬʷ  ;  l̥̟̟̟̟rʰɒpuz  ;  l̥̟̟̟̟rʰoɔkʰo  ;  l̥̟̟̟̟rʰobɔn͜no  ;  l̥̟̟̟̟rʰoɡrʰɒpʰo  ;  l̥̟̟̟̟rʰoorɒo  ;  l̥̟̟̟̟rʰoɬʷɒkʰo  ;  l̥̟̟̟̟rʰozdokɒo  ;  l̥̟̟̟̟rʰoɬʷkon͜nuon͜n  ;  l̥̟̟̟̟rʰoɬʷpʰon͜nɔo  ;  l̥̟̟̟̟rʰodu  ;  l̥̟̟̟̟rʰopʰoduzo  ;  l̥̟̟̟̟rʰodɒwloz  ;  l̥̟̟̟̟rʰododoko̥ɬʷ  ;  l̥̟̟̟̟rʰopomɒ  ;  l̥̟̟̟̟rʰy̥dɒn͜nuz  ;  l̥̟̟̟̟rʰun͜noɬʷ  ;  pdɔrʰn͜no  ;  pduzɒn͜no  ;  pdyŋkz  ;  pdokz  ;  pykn͜noɬʷ  ;  pʏro  ;  pʏrɒm͜muɬʷ  ;  pyrʰzoɬʷ  ;  podʰoɬʷ  ;  porʰn͜noɬʷ  ;  poɬʷuz  ;  podmoɬʷ  ;  pyɒn͜noɬʷ  ;  pykzoɬʷ  ;  poloz  ;  zɒkdɒz  ;  zɒn͜nn͜nɒz  ;  zɒpudʰoɬʷ  ;  zɒrʰkz  ;  zɒdrʰɒ  ;  zɔbɒz  ;  zɔbomɔ  ;  zɔzy̥pʰoɬʷ  ;  zudɒroɬʷ  ;  zuzo  ;  zukyoɬʷ  ;  zulu̥roɬʷ  ;  zuzɒron͜n  ;  zɒɡɒpon͜non͜n  ;  zɒn͜ndɒl̥odʰoko  ;  zɒrʰko̥kolo  ;  zɒdʏruzko̥ɬʷ  ;  zɒwrʰokdon͜noɬʷ  ;  zuzon͜n  ;  zɔm͜mn͜noɬʷ  ;  zɔrʰɡy  ;  zom͜muo  ;  zuɡo  ;  zudorurʰɡoɬʷ  ;  zuduon͜n  ;  zudon͜nuon͜n  ;  zuopo  ;  zkɒroɬʷ  ;  zkɒl̥uz  ;  zkɒn͜ndɒl̥uzo  ;  zkɒlɔdoɬʷ  ;  zkoʍɒzo  ;  zkuɒ  ;  zkuouz  ;  zkʏkuon͜n  ;  zko̥puo  ;  zko̥lydʰrʰon͜n  ;  zko̥doɬʷ  ;  zkɪroɬʷ  ;  zko̥loɬʷ  ;  zmɒo  ;  zolun͜noɬʷ  ;  zopʰuzmoɬʷ  ;  zu̥ɬʷun͜noɬʷ  ;  zpɒrdun͜noɬʷ  ;  zpun͜ndɒl̥oɬʷ  ;  zpɒdʰopʰoroɬʷ  ;  zpɒrɡɒn͜nuon͜n  ;  zpurɔɒ  ;  zpowdo  ;  zpodoɬʷ  ;  zporoɬʷ  ;  zdɔɡo  ;  zdulbo  ;  zdɒzuɒrʰkʰoz  ;  zdɒpʰʏlɒɡrʰɒ  ;  zdɔz  ;  zdɔlɔɒ  ;  zdɔn͜noo  ;  zdoɒ  ;  zdʏkʰuoo  ;  zdokʰɒzomɔ  ;  zdʏkʰoɬʷ  ;  zdrʰukz  ;  zdrʰɒŋ͜ŋɡʊ̜ruɒ  ;  zdrʰɒdoɡuɒ  ;  zdrʰɒdopɒdon͜n  ;  zdrʰopʰɒl̥uŋ͜ŋkz  ;  zdrʰomɒ  ;  zdʏpʰo  ;  zdoruŋ͜ŋkz  ;  zyŋɡrʰɒpʰoʍʰz  ;  zyŋko̥po  ;  zy̥ko̥pʰɒn͜nduɒ  ;  zyllɔɡo  ;  zymbɔn͜no  ;  zymmɒkʰɔo  ;  zympɒrɒdɒkzuz  ;  zympodoz  ;  zy̥n͜nɔrɔzuz  ;  zy̥n͜nɒpʰoz  ;  zy̥n͜nɔkzɔrʰkʰomɔ  ;  zy̥n͜ny̥kuzo  ;  zyn͜ndɔluɒ  ;  zyzdɔllo  ;  zpʰɒɡn͜noɬʷ  ;  zpʰɒl̥ɒroɬʷ  ;  zpʰuŋ͜ŋkdoɬʷ  ;  zpʰʏzo  ;  zkʰɔm͜mɒ  ;  zkʰɒl̥uz  ;  zkʰun͜noɬʷ  ;  zy̥bɒz  ;  zympʰʏzuz  ;  zyn͜ndʰɔzuz  ;  zyun͜noɬʷ  ;  zomɒ  ;  zodrʰon͜n  ;  dɒkzuz  ;  dɒkʰ  ;  dɔ  ;  dɔrɒm͜mn͜non͜n  ;  dɔdrʰukz  ;  dodʰyon͜n  ;  dul̥̟̟̟̟rʰɒzzuz  ;  dɒɡon͜n  ;  dɒrɒzzo  ;  dɒwrʰoɬʷ  ;  dun͜no  ;  dukʰopʰʏlɒkz  ;  dɔloɺ̥̟̟̟̟ʰdɔoɬʷ  ;  dɔrʰmun͜ndʰun͜noɬʷ  ;  dɔdɒn͜noɬʷ  ;  dɔdrʰɒkykloɬʷ  ;  doʍʰdɒzo  ;  dɔkʰn͜noɡrʰɒpʰoɬʷ  ;  dom͜mɔlɔo  ;  dlom͜mon͜n  ;  dy  ;  domoɬʷ  ;  dopuko̥ɬʷ  ;  drʰɒkʰoloɬʷ  ;  drʰɔpo  ;  drʰuɔn͜nɒ  ;  drʰuboloɬʷ  ;  drʰuzmɒkɒr  ;  drʰupʰyllon͜n  ;  drʰɒɡɔlɒpʰoɬʷ  ;  drʰuklun͜nuon͜n  ;  drʰuoduɬʷ  ;  drʰopʰuko̥ɬʷ  ;  drʰokʰoɬʷ  ;  drʰomoɬʷ  ;  drʰy̥zuz  ;  dʏkɒn͜no  ;  dolmɒ  ;  dorʰn͜noɬʷ  ;  doɬʷzoɬʷ  ;  dʏrun͜noɬʷ  ;  dyɽrʷʰdʰuz  ;  dodo  ;  duloɬʷ  ;  dʏpʰoɬʷ  ;  do  ;  hyon͜noɬʷ  ;  pʰɒn͜l̥lɔn͜nɒ  ;  pʰɒrzoɬʷ  ;  pʰɔrʰn͜nuon͜n  ;  pʰɒn͜noɬʷ  ;  pʰɒrkuz  ;  pʰɒwloɬʷ  ;  pʰu  ;  pʰn͜dʰun͜nɒ  ;  pʰn͜dʰɒrʰdoɬʷ  ;  pʰn͜dʰon͜noɬʷ  ;  pʰulorɔdmoɬʷ  ;  pʰulodokzuɒ  ;  pʰulokzɔn͜noɬʷ  ;  pʰulodoz  ;  pʰlykdɔn͜nɒ  ;  pʰʏdɒo  ;  pʰokzun͜noɬʷ  ;  l̥̟̟̟̟ʰrʰɒdoz  ;  l̥̟̟̟̟ʰrʰon͜nozuz  ;  pʰyo  ;  pʰʏzodorʰ  ;  pʰon͜no  ;  pʰoɬʷ  ;  kʰɒl̥ukz  ;  kʰɒrɒɡmɒ  ;  kʰɔo  ;  kʰorɒ  ;  kʰɒn͜lʰkoroz  ;  kʰɒn͜lʰko̥ɬʷ  ;  kʰɒm͜mɔ  ;  kʰɒm͜mɔloʍʰko  ;  kʰɒm͜mɔplɒdɒn͜noɬʷ  ;  kʰɒrdodʰoko  ;  kʰum͜mʰɒzdrʰon͜n  ;  kʰuron͜nupdrʰon͜n  ;  kʰɔludon͜n  ;  kʰɔrʰmɒz  ;  kʰum͜mʰɔropʰʏlɒkz  ;  kʰlɒm͜myz  ;  kʰloroɬʷ  ;  kʰolo  ;  kʰorɒwloz  ;  kouko̥ɬʷ  ;  kʰrʰɒomɔ  ;  kʰrʰɔoɬʷ  ;  kʰrʰozdodoz  ;  kʰrʰy̥zolɒkʰɒn͜non͜n  ;  kʰrʰy̥zopʰʏlɒkz  ;  kʰʏloɬʷ  ;  kʰydrʰopuɬʷ  ;  kʰoroɡrʰɒpʰoɬʷ  ;  pzɒn͜l̥mɒ  ;  pzɔdrʰɒ  ;  pzɒwrʰuoɬʷ  ;  pzɔlloɬʷ  ;  pzowdoɡrʰɒpʰoɬʷ  ;  pzowdon͜ny̥moɬʷ  ;  pzykʰrʰoɬʷ  ;  pzoloɬʷ  ;  ɒw  ;  ɒbyrʰdɒko  ;  ɒɡɒpo  ;  ɒɡɒdʰoɬʷ  ;  ɒŋ͜ŋɡodʰoko  ;  ɒɡɔn͜nɔɒl̥oɡodoɬʷ  ;  ɒŋ͜ŋko̥n͜n  ;  ɒɡn͜noɬʷ  ;  ɒɡoro  ;  ɒɡrʰuokun͜nɒrɒ  ;  ɒŋ͜ŋkʰuzduɒ  ;  ɒɡon͜nuɒ  ;  ɒdɒrʰko  ;  ɒdɔzpodoɬʷ  ;  ɒduɒbɒoɬʷ  ;  ɒɔrʰɡoɬʷ  ;  ɒkɒl̥opʰo  ;  ɒkɒdɒzkoʍɒzdoɬʷ  ;  ɒkudn͜noɬʷ  ;  ɒkrʰɒoz  ;  ɒkrʰobɒdoz  ;  ɒl̥ɒboz  ;  ɒn͜l̥ɒomɔ  ;  ɒl̥ɒkzupʰɒrmɒko̥n͜n  ;  ɒl̥odʰuo  ;  ɒn͜l̥lolon͜n  ;  ɒn͜l̥pʰɒduon͜n  ;  ɒl̥opokz  ;  ɒm͜mɒn͜ndɒl̥oɬʷ  ;  ɒm͜mɔrʰɡo  ;  ɒm͜mblyz  ;  ɒm͜my̥bo  ;  ɒm͜mpɒlol̥̟̟̟̟rʰɒzon͜n  ;  ɒm͜mpʰubɒn͜l̥lo  ;  ɒm͜mpʰupɒn͜nomɔ  ;  ɒm͜morʰɡun͜noɬʷ  ;  ɒm͜myɡdɒl̥on͜n  ;  ɒm͜my̥n͜no  ;  ɒn͜nɒl̟̟̟̟rʰoɬʷuz  ;  ɒn͜nɒɡo  ;  ɒn͜nɒdɒkzuz  ;  ɒn͜nukodoɬʷ  ;  ɒn͜nɒuzzo  ;  ɒn͜nɒn͜l̥ɡozuɒ  ;  ɒn͜nɒm͜mum͜mʰn͜nozko̥  ;  ɒn͜nɒzkoʍɒzo  ;  ɒn͜ndrʰuoɬʷ  ;  ɒn͜ndʰɔo  ;  ɒn͜ndʰrʰopoloɡoɬʷ  ;  ɒn͜ndʰolopz  ;  ɒn͜noruo  ;  ɒn͜ndubuoɬʷ  ;  ɒn͜ndudʰɔdon͜n  ;  ɒn͜nduɽrʷʰdʰun͜non͜n  ;  ɒkzuol̥̟̟̟̟rʰɔpoz  ;  ɒorʰdorʰ  ;  ɒpɒn͜noɺ̥̟̟̟̟ʰn͜dʰɔn͜n  ;  ɒpuruɒ  ;  ɒpɒruzuoɬʷ  ;  ɒpobɒzuloʍʰz  ;  ɒpʏkuɒ  ;  ɒpoko̥pdo  ;  ɒpoplɔo  ;  ɒporɔo  ;  ɒpoɬʷdolo  ;  ɒpokʰorɔo  ;  ɒpodrʰɒzuz  ;  ɒpolly̥mu  ;  ɒpomɒkdrʰon͜n  ;  ɒpon͜n  ;  ɒrɒzzo  ;  ɒrʰbɒl̥o  ;  ɒrʰɡʏruɬʷ  ;  ɒrʰɡʏruon͜n  ;  ɒrʰɡɒz  ;  ɒroupʰuloɬʷ  ;  ɒrudʰmɔo  ;  ɒruzdoʍʰz  ;  ɒrʰkɒo  ;  ɒry̥bɒn͜l̥luz  ;  ɒrʰkʰɒŋ͜ŋɡɔloɬʷ  ;  ɒrʰkʰurɒbdʊkʰoɬʷ  ;  ɒroo  ;  ɒzdʰɔn͜nɔo  ;  ɒzkɒn͜ndoz  ;  ɒzpuz  ;  ɒzdrʰɒpo  ;  ɒzdʏɡudon͜n  ;  ɒzpʰɒl̥oɬʷ  ;  ɒzyn͜ndɔdoɬʷ  ;  ɒzodoz  ;  ɒdɒn͜l̥lo  ;  ɒdɒzdʰɒl̥oɬʷ  ;  ɒdrʰɒpʰɒkzyz  ;  ɒpʰɔrɔo  ;  ɒpʰoruzo  ;  ɒl̥̟̟̟̟ʰrʰoɬʷy̥n͜no  ;  ɒkʰɒdoz  ;  ɒkʰlyz  ;  ɒkrʰuoɬʷ  ;  ɒpzun͜ndʰuon͜n  ;  hɒl̟̟̟̟rʰoduɔdoɬʷ  ;  hɒɡn͜nuzmoɬʷ  ;  hɒdun͜noɬʷ  ;  hɒl̥uporʰpʰʏroɬʷ  ;  hɒl̥my̥roɬʷ  ;  hɒm͜mɒrʰdɒn͜nu  ;  ɒɒpdoɬʷ  ;  ɒbɒdoɬʷ  ;  ɒɡɒm͜mɔ  ;  ɒɡrʰɒpʰoɬʷ  ;  ɒɔdʰlon͜n  ;  ɒkɒn͜ndʰoɬʷ  ;  ɒko̥loɬʷ  ;  ɒko̥roɬʷ  ;  ɒkrʰudʰoɬʷ  ;  ɒl̥ɒzdoɬʷ  ;  ɒn͜l̥ɡom͜mɒ  ;  ɒl̥upʰɒr  ;  ɒn͜l̥loɬʷ  ;  ɒm͜mbon͜n  ;  ɒn͜n  ;  ɒn͜nɒrʰdʰrʰoɬʷ  ;  ɒn͜nɔo  ;  ɒn͜nodoɬʷ  ;  ɒn͜nodʰɔn͜n  ;  ɒkzon͜n  ;  ɒplozdoɬʷ  ;  ɒrɒboɬʷ  ;  ɒruoɬʷ  ;  ɒr̥ʰmɔn͜non͜n  ;  ɒɽrʰdʰoɬʷdoɬʷ  ;  ɒrʰzon͜n  ;  ɒrʰdoɬʷ  ;  ɒzkuoɬʷ  ;  ɒzko̥poɬʷ  ;  ɒdo  ;  ɒpʰn͜dʰudoɬʷ  ;  hɒm͜mullɒ  ;  hɒrmɒ  ;  ɒdʰlon͜n  ;  ɒbuɒ  ;  ɒɡozulɒoɬʷ  ;  ɒɡrʰuppun͜no  ;  ɒdʊɬʷuoɬʷ  ;  ɒdrʰyɒz  ;  ɒon͜nobɒrʰboɬʷ  ;  ɒdʰon͜nozun͜n  ;  ɒdʰon͜nɒ  ;  ɒkdɔon͜n  ;  ɒkʏluoɬʷ  ;  ɒl̥kɒm͜mɔn͜noz  ;  ɒl̥kmon͜no  ;  ɒn͜l̥yɒddoz  ;  ɒm͜mɒzon͜n  ;  ɒm͜mpʰudʰoo  ;  ɒn͜nɒpʰo  ;  ɒn͜nɒkzum͜mʰɔn͜noz  ;  ɒn͜ndɒn͜nuɒ  ;  ɒn͜ndun͜nooɬʷ  ;  ɒn͜ndupɒz  ;  ɒn͜ndukʏdʰorɒ  ;  ɒn͜ndrʰon͜n  ;  ɒpɒdʊ̜ruɒ  ;  ɒpudɒn͜noɬʷ  ;  ɒpʊlouoɬʷ  ;  ɒruzbo  ;  ɒrɒm͜mɔy  ;  ɒrʰɡum͜mʰpɒzɒ  ;  ɒruɒbuɡn͜noz  ;  ɒruzdomɒkʰoɬʷ  ;  ɒruzdon͜ny̥moɬʷ  ;  ɒr̥ʰdɔm͜muzuon͜n  ;  ɒr̥ʰkʰɔlɒoɬʷ  ;  ɒrʰkʰudɒm͜moɬʷ  ;  ɒzɔɒ  ;  ɒzzy̥ruɒ  ;  ɒzdɔruon͜n  ;  ɒdlɒn͜nduz  ;  ɒdduko̥ɬʷ  ;  ɒkɒuɒ  ;  hɒdʰyrʰ  ;  hɒl̥ukyɔ  ;  ɒɡbɒl̥oɬʷ  ;  ɒl̥oɬʷ  ;  ɒm͜mɒzuz  ;  ɒm͜mmon͜n  ;  ɒn͜ndrʰoɬʷ  ;  ɒn͜ndupʰoɬʷ  ;  ɒrʰn͜no  ;  ɒrʰpy  ;  ɒzuoɬʷ  ;  ɒdrʰopoɬʷ  ;  ɔŋ͜ŋɡʏdʰoko  ;  ɔŋ͜ŋkrʰɒduɒ  ;  ɔuko̥ɬʷdoɬʷ  ;  ɔku  ;  ɔkporowo  ;  ɔlɒdun͜noɬʷ  ;  ɔloɺ̥̟̟̟̟ʰn͜dʰɔropzy̥kʰoɬʷ  ;  ɔlɔoɬʷ  ;  ɔlloɬʷ  ;  ɔm͜mmɔn͜no  ;  ɔm͜mpʏɔo  ;  ɔm͜mpʏruzmoɬʷ  ;  ɔn͜nɒn͜nduon͜n  ;  ɔn͜ndɔlɔkʰoz  ;  ɔn͜ndʏn͜no  ;  ɔn͜ndʰɒdɔ  ;  ɔn͜ndʰrʰon͜nuoɬʷ  ;  ɔn͜ndɔllo  ;  ɔn͜ndoɬʷ  ;  ɔn͜nypn͜nuoɬʷ  ;  ɔkzɒpdo  ;  ɔkzɔn͜nɒruzo  ;  ɔkzomoloɡoduko̥ɬʷ  ;  ɔpɒɡo  ;  ɔpum͜mʰɒkʰoɬʷ  ;  ɔpɒn͜ndudʰom͜mu  ;  ɔpubɔn͜no  ;  ɔpuɡloɬʷzuz  ;  ɔpuukoz  ;  ɔpukɒn͜l̥ɒo  ;  ɔpukrʰɒdɔo  ;  ɔpum͜mʰukz  ;  ɔpuɽrʷʰnʰɔpo  ;  ɔpuzdɔllo  ;  ɔpudodowmɒ  ;  ɔpupʰorɒ  ;  ɔpokʰo  ;  ɔpon͜ny̥mon͜n  ;  ɔrɔdoz  ;  ɔrʰɡɒzdorʰ  ;  ɔrɔun͜no  ;  ɔrukʏdoz  ;  ɔry̥ko̥  ;  ɔromɔn͜noɬʷ  ;  ɔrom͜moɬʷ  ;  ɔzdʰuo  ;  ɔzkʰɒruon͜n  ;  ɔdoɬʷuoɬʷ  ;  ɔpʰɒn͜l̥lomɔ  ;  ɔpʰowrʰuzko̥  ;  ɔkʰun͜nopuɬʷ  ;  ɔyɔrʰɡoz  ;  hɒbdomoko̥n͜ndɒkɒɔkɒdon͜ndɒplɒzuon͜n  ;  hɒkkɒdɔkɒdoɬʷ  ;  hɒlɔdon͜no  ;  hɒkzoko̥n͜ndɒm͜my̥roɬʷ  ;  hɒdɔrɒ  ;  hɒdɔrɒl̥koz  ;  hɒdɔron͜ny̥moɬʷ  ;  hɒdʏmoɬʷ  ;  ɔpzulon͜n  ;  ɔl̟̟̟̟rʰoɬʷ  ;  ɔŋ͜ŋkɒwmɒ  ;  ɔŋ͜ŋkʰɔlyz  ;  ɔdʰo  ;  ɔɡɡon͜noɬʷ  ;  ɔkpɒɡloɬʷ  ;  ɔkdɒzuz  ;  ɔlɔon͜n  ;  ɔly̥moɬʷ  ;  ɔm͜ml̟̟̟̟rʰyon͜n  ;  ɔm͜mpuroɬʷ  ;  ɔn͜nzdɒzuz  ;  ɔpudʰ  ;  ɔpɒpʰn͜non͜n  ;  ɔrupʰoɬʷ  ;  ɔroɬʷ  ;  ɔry̥zoɬʷ  ;  hɒkdoɬʷ  ;  hɒo  ;  hɒpomɔ  ;  hɒzpɒroɬʷ  ;  ɔlɔpʰon͜norʰ  ;  ɔlpuz  ;  ɔkzɔn͜nɔdoɬʷ  ;  ɔpudɒm͜mn͜noɬʷ  ;  ɔrɒdokludoz  ;  ɔrydʰrʰɒdʰɒl̥ɒzzɒ  ;  ɔpʰuɒn͜l̥doz  ;  ɔl̥̟̟̟̟ʰrʰɔm͜m  ;  ɔkʰɔm͜ml̟̟̟̟rʰodoɬʷ  ;  hɒkɒbo  ;  hɒkɒdo  ;  olvʷun̪͜ðuoɬʷ  ;  hɒlkɒdʰuon͜n  ;  hɒrmoɡɔn͜noz  ;  ɔdɔzzɒ  ;  ɔn͜nn͜nɒ  ;  hɒllo  ;  oyz  ;  oɡɒdʰɔoɬʷ  ;  odʰɔo  ;  oly̥ɡɔoɬʷ  ;  opuoloɬʷ  ;  holuɒzomɔ  ;  holuomɒn͜nduɒ  ;  hom͜mɔrɒ  ;  hom͜mukrʰɒn͜nuɒ  ;  hom͜mudɒl̥ɒn͜ndon͜n  ;  hozy̥kʰɒzdoz  ;  odʰo  ;  on͜nyzdrʰon͜n  ;  horoɬʷ  ;  hodoɬʷ  ;  odon͜noɬʷ  ;  okʰo  ;  hoɡozupʏlo  ;  horɒklɔodoz  ;  horoɬʷdrʰɒdoɬʷ  ;  uɒkʰo  ;  udɔɒ  ;  uduomɒ  ;  uoudoz  ;  uzkʰuon͜n  ;  uzopzopʰoɬʷ  ;  ukʰdʰʏɒo  ;  huɔrɒkz  ;  hudrʰoo  ;  huɔromyrʰdoɬʷ  ;  hukɒduɒ  ;  hum͜mʰɒduon͜n  ;  huppol̥̟̟̟̟rʰoɬʷopoɬʷ  ;  huppodrʰomoɬʷ  ;  huppokrʰom͜mn͜noɬʷ  ;  huppopʰlomoɬʷ  ;  huroɬʷ  ;  huzdoruko̥ɬʷ  ;  uɒzuz  ;  uɡduz  ;  ukrʰuɒ  ;  ulɒrʰkʰoɬʷ  ;  un͜ndʊ̜roɬʷ  ;  ukʰn͜noɬʷ  ;  huom͜mu  ;  hun͜n  ;  uluŋ͜ŋkz  ;  upoɬʷ  ;  uɒn͜l̥mɔn͜noɬʷ  ;  uɒbɔzɔbydʰ  ;  uɒkzɒm͜mɒdɔ  ;  udʰomodoz  ;  ully̥ruoɬʷ  ;  un͜nopopʰʏlɒkz  ;  uu̥dɒuko̥ɬʷ  ;  uu̥n͜nuoɬʷ  ;  uzmɒol  ;  uzon͜ndɔ  ;  udɒl̥oɬʷ  ;  upʰuɡɔn͜nuɒ  ;  uon͜nopoluz  ;  uoppu  ;  huɔrukʰo  ;  huɔropʰon͜n  ;  uzbʊ̜roɬʷ  ;  udʏloɬʷ  ;  obɔluzko̥ɬʷ  ;  okrʰuz  ;  oluɡɒrʰkʰuko̥ɬʷ  ;  oluɡopzy̥kʰɔo  ;  olopʰydn͜noɬʷ  ;  on͜nuzko̥ɬʷ  ;  on͜nuduzo  ;  on͜nomɒzduko̥n͜n  ;  okzyɒ  ;  okzyun͜noɬʷ  ;  opɒn͜l̥luoɬʷ  ;  opdoɬʷ  ;  orʰɡuzo  ;  orʰdʰodokzuɒ  ;  oropʰo  ;  ory̥mɒɡdoɬʷ  ;  orʰkʰɔomɔ  ;  oɬʷdun͜n  ;  okʰdʰɔo  ;  opzodʰoko  ;  homyodrʰopoɬʷ  ;  horuzon͜n  ;  horʰmɒdʰoɬʷ  ;  ol̟̟̟̟rʰy̥zon͜n  ;  oɡmoɬʷ  ;  olly̥mu  ;  ompʰɒkz  ;  on͜ny̥mɒ  ;  opuzdʰɔn͜n  ;  orɔkzuz  ;  opʰɔlon͜n  ;  hodʰɔn͜n  ;  homuloɬʷ  ;  homoroɬʷ  ;  hoplon͜n  ;  horɒzuz  ;  hoɬʷuoɬʷ  ;  hoɬʷpɒr  ;  hoɬʷzoɬʷ  ;  hodɔ  ;  hoddu  ;  odʏzoʍʰz  ;  odomɒn͜ndy  ;  olooɬʷzon͜n  ;  olympuoɬʷ  ;  oml̟̟̟̟rʰuko  ;  okzyɽrʷʰdʰyŋkʰoɬʷ  ;  opuɬʷ  ;  orʰn͜nɔɒdoz  ;  ory̥doz  ;  ol̥̟̟̟̟ʰrʰy̥n͜nuon͜n  ;  horʰdozuoɬʷ  ;  olbɒzɒ  ;  hyɡrʰopʰn͜dʰoŋɡoɬʷ  ;  hydrʰokɒpʰɒl̥on͜n  ;  hydrʰoɬʷko̥puon͜n  ;  hy̥pɒrl̥̟̟̟̟ʰrʰon͜n  ;  hy̥pɒn͜l̥lɒzzo  ;  hy̥pɒrn͜nɔpʰɔloɬʷ  ;  hy̥porɔzuɒ  ;  hy̥poklɔpdo  ;  hy̥pomɔn͜no  ;  hy̥poɬʷdɒdoz  ;  hy̥podɔlɔo  ;  hy̥pobɒdʰrʰon͜n  ;  hy̥podom͜mɒ  ;  hyzdɔrom͜mɒ  ;  hy̥pʰoɡozuz  ;  hypzodʰɔn͜n  ;  hyopʰn͜dʰɒn͜l̥moɬʷ  ;  ymmɔz  ;  hyɒl̥oɬʷ  ;  hy̥pɒdoɬʷ  ;  hy̥rɒkz  ;  hypzu  ;  hyz  ;  hy̥mɔz  ;  hy̥pɒrbɔrɔdɔoɬʷ  ;  hy̥pɒrozuo  ;  hyblo  ;  hy̥duzzɒ  ;  hyzzoɬʷ  ;  okum͜mʰoudɔz  ;  omodrʰuboz  ;  opʰɔlɔo  ;  orɒ  ;  oruon͜n  ;  oɬʷduɒ  ;  odo  ;  rʰɒzmɒ  ;  rʰɒm͜mmɒdun͜noɬʷ  ;  rʰɒpʰudodʰoko  ;  rʰudʰrʰon͜n  ;  rʰodoruko̥ɬʷ  ;  rʰun͜nodoroɬʷ  ;  rʰuzko̥pʰʏlɒkz  ;  rʰomboudoz  ;  rʰydʰmoɬʷ  ;  rʰy̥pɒropʰɒɡoɬʷ  ;  rʰy̥duz  ;  rʰokʰmoɬʷ  ;  rʰomo  ;  rʰɒdʰʏmoɬʷ  ;  rʰɒbɔn͜nn͜nɒ  ;  rʰɔɒ  ;  rʰobɒz  ;  rʰon͜nuɒ  ;  rʰuzuɬʷ  ;  rʰu̥bon͜n  ;  rʰodo  ;  